ACADIA UNIV	Canada
ALBERTA CANC BOARD	Canada
ALBERTA CHILDRENS PROV GEN HOSP	Canada
ALBERTA HLTH & WELLNESS	Canada
ALBERTA PROV LAB	Canada
ARTHRIT RES CTR CANADA	Canada
ARTHRITIS RES CTR CANADA	Canada
BISHOPS UNIV	Canada
BRANDON UNIV	Canada
BRITISH COLUMBIA CANC AGCY	Canada
BRITISH COLUMBIA CTR DIS CONTROL	Canada
CANADA ARTHRIT COMMUNITY RES & EVALUAT UNIT	Canada
CANADA CLIN TRIALS GRP	Canada
CANADA HLTH INFOWAY	Canada
CANADIAN BLOOD SERV	Canada
CANADIAN CANC SOC	Canada
CANADIAN FORCES BASE	Canada
CANADIAN FORCES HLTH SERV	Canada
CANADIAN HLTH SERV RES FDN	Canada
CANADIAN IMMUNODEFICIENCY RES COLLABORAT	Canada
CANADIAN INST HLTH INFORMAT	Canada
CANADIAN INST HLTH RES	Canada
CANADIAN MEM CHIROPRACT COLL	Canada
CANADIAN PARTNERSHIP CANC	Canada
CANADIAN PARTNERSHIP CANCER	Canada
CANADIAN PHYSIOTHERAPY ASSOC	Canada
CANADIAN SCI CTR HUMAN & ANIM HLTH	Canada
CANADIAN THORAC SOC	Canada
CANADIAN TUMOUR REPOSITORY NETWORK	Canada
CANADIAN WORKING GRP HIV & REHABIL	Canada
CANC COUNCIL VICTORIA	Canada
CAPE BRETON UNIV	Canada
CHILDRENS & WOMENS HLTH CTR BRITISH COLUMBIA	Canada
CISTI (Canada Institute for Scientific and Technical Information)	Canada
CONCORDIA UNIV	Canada
CONCORDIA UNIV	Canada
CRIR CONSTANCE LETHBRIDGE REHABIL CTR	Canada
CROHNS & COLITIS FDN CANADA	Canada
CRULRG UNIV LAVAL	Canada
DALHOUSIE UNIV	Canada
DALHOUSIE UNIV	Canada
DEF RES & DEV CANADA	Canada
DR EVERETT CHALMERS REG HOSP	Canada
DR H BLISS MURPHY CANC CTR	Canada
ECOLE POLYTECH MONTREAL	Canada
GENOM LSSU	Canada
GENOM RES LAB	Canada
GENOME ALBERTA	Canada
GENOME CANADA	Canada
GENOME QUEBEC INNOVAT CENTRE	Canada
GENOME QUEBEC INNOVAT CTR	Canada
GENOME QUEBEC INNVOAT CTR	Canada
HEALING HANDS HAITI TEAM CANADA HEALING HANDS	Canada
HEALTHY ENVIRONM & CONSUMER SAFETY BRANCH	Canada
HEART & STROKE FDN	Canada
HEART & STROKE FDN CTR STROKE RECOVERY	Canada
HEART & STROKE RICHARD LEWAR CTR CARDIOVASC EXCEL	Canada
HEART & STROKE RICHARD LEWAR CTR EXCELLENCE	Canada
HEART & STROKE RICHARD LEWAR CTR EXCELLENCE CARDI	Canada
HEC MONTREAL	Canada
HLTH CANADA	Canada
HLTH PROTECT AGCY	Canada
HLTH QUAL COUNCIL	Canada
INST UNIV CARDIOL & PNEUMOL QUEBEC	Canada
MANITOBA CTR HLTH POLICY	Canada
MANITOBA INST CELL BIOL	Canada
MCGILL UNIV	Canada
MEM HOSP	Canada
MEM UNIV NEWFOUNDLAND	Canada
MEM UNIV NEWFOUNDLAND	Canada
MT ALLISON UNIV	Canada
MT ST VINCENT UNIV	Canada
NATL CANC INST CANADA	Canada
NATL RES COUNCIL CANADA	Canada
NATL RES COUNCIL CANADA	Canada
OSTEOPOROSIS CANADA	Canada
PROV LAB PUBL HLTH ALBERTA	Canada
PUBL HLTH AGCY CANADA	Canada
SASKATCHEWAN DIS CONTROL LAB	Canada
SASKATOON HLTH REG	Canada
SIMON FRASER UNIV	Canada
ST FRANCIS XAVIER UNIV	Canada
ST MARYS UNIV	Canada
TEAM CANADA HEALING HANDS	Canada
UNIV ALBERTA	Canada
UNIV ALBERTA	Canada
UNIV BRITISH COLUMBIA	Canada
UNIV BRITISH COLUMBIA	Canada
UNIV CALGARY	Canada
UNIV CALGARY	Canada
UNIV FRASER VALLEY	Canada
UNIV LAVAL	Canada
UNIV LAVAL	Canada
UNIV LAVAL HOSP RES CTR CRCHUL	Canada
UNIV LAVAL ROBERT GIFFORD	Canada
UNIV LETHBRIDGE	Canada
UNIV MANITOBA	Canada
UNIV MONCTON	Canada
UNIV MONTREAL	Canada
UNIV MONTREAL	Canada
UNIV NEW BRUNSWICK	Canada
UNIV NORTH BRITISH COLUMBIA	Canada
UNIV OTTAWA	Canada
UNIV PRINCE EDWARD ISL	Canada
UNIV PRINCE EDWARD ISL	Canada
UNIV QUEBEC	Canada
UNIV QUEBEC	Canada
UNIV QUEBEC CHICOUTIMI	Canada
UNIV QUEBEC MONTREAL	Canada
UNIV QUEBEC TROIS RIVIERES	Canada
UNIV REGINA	Canada
UNIV SASKATCHEWAN	Canada
UNIV SASKATCHEWAN	Canada
UNIV SHERBROOKE	Canada
UNIV VICTORIA	Canada
UNIV VICTORIA	Canada
UNIV WINNIPEG	Canada
VANCOUVER COASTAL HLTH	Canada
VANCOUVER COASTAL HLTH AUTHOR	Canada
VICTORIA HEART INST FDN	Canada
VICTORIA RES LAB CTR	Canada
VON CANADA	Canada
WESTERN RESERVE CARE SYST	Canada
WESTERN UNIV HLTH SCI	Canada
Algoma University	Ontario
BLOORVIEW KIDS REHAB	Ontario
BLOORVIEW RES INST	Ontario
BLOORVIEW RES INST & BLOORVIEW KIDS REHAB	Ontario
BLOORVIEWS KIDS REHAB	Ontario
BRIDGEPOINT HLTH	Ontario
BROCK UNIV	Ontario
Brock University	Ontario
CAMH	Ontario
CAMPBELL FAMILY CANC RES INST	Ontario
CAMPBELL FAMILY INST BREAST CANC RES	Ontario
CAMPBELL FAMILY INST CANC RES	Ontario
CAMPUS VIRCHOW KLINIKUM	Ontario
CANC CARE ONTARIO	Ontario
CARLETON UNIV	Ontario
Carleton University	Ontario
COLL PHYSIOTHERAPISTS ONTARIO	Ontario
CREDIT VALLEY HOSP	Ontario
CTR ADDICT & MENTAL HLTH	Ontario
DURHAM REG CANC CTR	Ontario
DURHAM REG HLTH DEPT	Ontario
ETOBICOKE GEN HOSP	Ontario
GTA REHAB NETWORK	Ontario
GTA REHAB NETWORK TORONTO ABI NETWORK	Ontario
HAMILTON HLTH SCI CORP	Ontario
HAMILTON REG LAB MED PROGRAM	Ontario
HOLLAND BLOORVIEW KIDS REHABIL HOSP	Ontario
JOSEPH BRANT MEM HOSP	Ontario
JOSEPHS HLTH CTR	Ontario
LAKEHEAD UNIV	Ontario
Lakehead University	Ontario
LAKERIDGE HLTH CORP	Ontario
LAKERIDGE HLTH CTR	Ontario
LAKERIDGE HLTH NETWORK	Ontario
LAURENTIAN UNIV	Ontario
Laurentian University	Ontario
MAPLE LEAF MED CLIN	Ontario
MARKHAM STOUFFVILLE HOSP	Ontario
MARS CTR	Ontario
MCGILL UNIV	Ontario
MCLAUGHLIN CTR MOL MED	Ontario
MCLAUGHLIN RES INST	Ontario
MCMASTER UNIV	Ontario
McMaster University	Ontario
MED CTR COBURG	Ontario
MT SINAI HOSP	Ontario
N YORK GEN HOSP	Ontario
N&E GREATER TORONTO AREA ONTARIO REG STROKE CTR	Ontario
NIAGARA HLTH SYST	Ontario
NIAGARA REG PUBL HLTH	Ontario
NIPISSING UNIV	Ontario
Nipissing University	Ontario
OCAD University	Ontario
ODETTE CANC CTR	Ontario
ONTARIO AGCY HLTH PROTECT & PROMOT	Ontario
ONTARIO FAMILIAL BREAST CANC REGISTRY	Ontario
ONTARIO FORENS PATHOL SERV	Ontario
ONTARIO GENOM INST	Ontario
ONTARIO MINIST ENVIRONM	Ontario
ONTARIO MINIST HLTH & LONG TERM CARE	Ontario
ONTARIO PUBL HLTH ASSOC	Ontario
ONTARIO PUBL HLTH LAB	Ontario
ONTARIO TOBACCO RES UNIT	Ontario
ONTARIO VET COLL	Ontario
PEEL PUBL HLTH	Ontario
PETER MACCALLUM CANC INST	Ontario
PETERBOROUGH REG HLTH CTR	Ontario
Queen’s University	Ontario
QUEENS UNIV	Ontario
Royal Military College of Canada (RMCC)	Ontario
RYERSON UNIV	Ontario
Ryerson University	Ontario
S MICHAELS HOSP	Ontario
SCARBOROUGH GEN HOSP	Ontario
SICKKIDS	Ontario
SICKKIDS HOSP	Ontario
SICKKIDS RES INST	Ontario
ST MICHAEL S HOSP	Ontario
ST MICHAELS HOSP	Ontario
SUNNYBROOK HLTH SCI	Ontario
SUNNYBROOK HLTH SCI CTR INDEPENDENT LIVING	Ontario
SUNNYBROOK ODETTE CANC CTR	Ontario
SUNNYBROOK WOMENS HLTH CTR	Ontario
THUNDER BAY DIST HLTH UNIT	Ontario
THUNDER BAY REG HLTH SCI CTR	Ontario
TORONTO BRAIN VASC MALFORMAT STUDY GRP	Ontario
TORONTO CTR PHENOGEN	Ontario
TORONTO E COUNSELLING & SUPPORT SERV	Ontario
TORONTO E GEN & ORTHOPED HOSP	Ontario
TORONTO HLTH ECON & TECHNOL ASSESSMENT COLLABORAT	Ontario
TORONTO INST PHARMACEUT TECHNOL	Ontario
TORONTO LUNG TRANSPLANT PROGRAM	Ontario
TORONTO MED DISCOVERY TOWER	Ontario
TORONTO PLATELET IMMUNOBIOL GRP	Ontario
TORONTO PUBL HLTH	Ontario
TORONTO REHAB	Ontario
TORONTO REHAB INST	Ontario
TORONTO REHABIL	Ontario
TORONTO REHABIL INST	Ontario
TORONTO RES INST	Ontario
TORONTO SEMI	Ontario
TORONTO SUNNYBROOK REG CANC CTR	Ontario
TRENT UNIV	Ontario
Trent University	Ontario
TRILLIUM HLTH CTR	Ontario
UHN TORONTO GEN HOSP	Ontario
UHN WOMENS HLTH PROGRAM	Ontario
UNIV HEATH NETWORK	Ontario
UNIV HLTH NETWORK	Ontario
UNIV HLTH NETWORK REHABIL SOLUT	Ontario
UNIV HLTH NETWORK TORONTO	Ontario
UNIV QUERYOF TORONTO	Ontario
UNIV VICTORIA	Ontario
UNIV WATERLOO	Ontario
UNIV WESTERN ONTARIO	Ontario
UNIV WINDSOR	Ontario
University of Guelph	Ontario
University of Ontario Institute of Technology	Ontario
University of Ottawa	Ontario
University of Toronto	Ontario
University of Waterloo	Ontario
University of Windsor	Ontario
VEIN INST TORONTO	Ontario
WESTERN GEN HOSP	Ontario
Western University	Ontario
WILFRID LAURIER UNIV	Ontario
Wilfrid Laurier University	Ontario
WOMENS COLL HOSP	Ontario
YORK REG HLTH SERV	Ontario
YORK UNIV	Ontario
York University	Ontario
514 DONNELLY CTR CELLULAR & BIOMOL RES	Other
5289 UNIV OREGON	Other
5289 UNIV OREGON	Other
A CARDARELLI HOSP	Other
AA BOGOMOLETS PHYSIOL INST	Other
AALBORG & AARHUS UNIV	Other
ABBOTT LABS	Other
ABERDEEN ROYAL INFIRM	Other
ABO AKAD UNIV	Other
ACOUST MEDSYST INC	Other
ACT MOTIF INC	Other
ACTIVEO	Other
ADDENBROOKES HOSP	Other
ADV MEDICARE & RES INST	Other
AFFINIUM PHARMACEUT INC	Other
AFFYMETRIX INC	Other
AGENCE BIOMED	Other
AGENCE SANTE & SERV SOCIAUX MONTEREGIE	Other
AGILENT	Other
AGR & AGRI FOOD CANADA	Other
AIR FORCE OFF SCI RES	Other
AIR FORCE RES LAB	Other
AIX MARSEILLE UNIV	Other
ALBANOVA UNIV CTR	Other
ALDER HEY CHILDRENS HOSP	Other
ALFRED & MONASH UNIV	Other
ALFRED HOSP	Other
ALFRED I DUPONT HOSP CHILDREN	Other
ALGEMEINE ZIEKENHUIS GROENINGHE	Other
ALLERGAN PHARMACEUT INC	Other
ALMOND BOARD CALIF	Other
ALMOND BOARD CALIFORNIA	Other
ALPCO DIAGNOST	Other
ALPHARMA	Other
ALTONAER KINDERKRANKENHAUS	Other
AMGEN EUROPE GMBH	Other
AMICUS THERAPEUT	Other
AMK RES INC	Other
ANALGESIC RES	Other
ANDALUSIAN STEM CELL BANK	Other
AP HP	Other
APHASIA INST	Other
APO PHARMA INC	Other
APOPHARMA INC	Other
APPL BIOSYST INC	Other
APPL BIOSYST PART LIFE TECHNOL	Other
ARTHRIT COMMUNITY RES & EVALUAT UNIT	Other
ARTHRITIS CTR EXCELLENCE	Other
ASCO	Other
ASKLEPIOS KLIN ST GEORG	Other
ASSAF HAROFE MED CTR	Other
ASTELLAS PHARMA GLOBAL DEV	Other
ASTELLAS PHARMA INC	Other
ASTELLAS RES INST AMER LLC	Other
ASTRAZENECA	Other
ASTRAZENECA R&D	Other
ATLANTIC HLTH SCI CORP	Other
AUTISM RES PROGRAM	Other
AUTISM SPEAKS	Other
AXELA BIOSENSORS	Other
B RAPPAPORT FAC MED	Other
B RAPPAPORT FAC MED TECHN	Other
BC CTR DIS CONTROL	Other
BCCDC	Other
BEATSON INST CANC RES	Other
BEIKE BIOTECH CO LTD	Other
BGI SHENZHEN	Other
BICHAT CLAUDE BERNARD UNIV HOSP	Other
BIOBANK POPGEN	Other
BIOBASE CORP	Other
BIOCTR KUOPIO	Other
BIOFIG CTR BIODIVERS FUNCT & INTEGRAT GENOM	Other
BIOFORTIS	Other
BIOINFORMED CONSULTING SERV	Other
BIOL RES CTR	Other
BIOMED NETWORK RES CTR RARE DIS	Other
BIOMED RES CTR CIBERESP	Other
BIONEER CORP	Other
BIOPOLIS	Other
BIOPT LAB	Other
BIORESOURCE COLLECT & RES CTR	Other
BIOSCIENTIA INST MED DIAGNOST	Other
BOEHRINGER INGELHEIM PHARMA GMBH & CO KG	Other
BOEHRINGER INGELHEIM PHARMACEUT INC	Other
BONE & JOINT REHABIL R&D CTR	Other
BOOTH HALL CHILDRENS HOSP	Other
BOSTWICK LABS	Other
BRAIN BANK NAVARRA	Other
BRAIN INJURY SERV NO ONTARIO	Other
BRISTOL MYERS SQUIBB CO	Other
BROOKE ARMY MED CTR	Other
BUCKS INST AGE RES	Other
BWH ACAD HOSPITALIST SERV	Other
CABI EUROPE UK	Other
CADHAM PROV LAB	Other
CADHAM PROV LABS	Other
CANC EPIDEMIOL CTR	Other
CANC GENOM CTR	Other
CANC PREVENT INST CALIF	Other
CANC RES INST	Other
CANCOG TECHNOL	Other
CANGENETEST RES CONSORTIUM GENET LAB SERV	Other
CAPHRI RES INST	Other
CARDIAC REHABIL & SECONDARY PREVENT PROGRAM	Other
CARDIOVASC RES CTR	Other
CARESTREAM HLTH INC	Other
CARESTREARN HLTH INC	Other
CARGILL INC	Other
CARTAGENE	Other
CARVER COLL MED	Other
CATALAN INST ONCOL IDIBELL	Other
CATHARINA HOSP	Other
CBI HLTH	Other
CEA	Other
CEDERINDT	Other
CEGEP JONQUIERE	Other
CELGENE CORP	Other
CELL SIGNALING TECHNOL	Other
CELL SIGNALING TECHNOL INC	Other
CELLARTIS AB	Other
CENT ARKANSAS VET HEALTHCARE SYST	Other
CENTOCOR PHARMACEUT	Other
CEPHALON INC	Other
CEREXA	Other
CERIM	Other
CESP CTR RES EPIDEMIOL & POPULAT HLTH	Other
CHA HOSP	Other
CHAIM CHEBA MED CTR	Other
CHAIM SHEBA MED CTR	Other
CHEIL HOSP	Other
CHEIL HOSP & WOMENS HEALTHCARE CTR	Other
CHEJU NATL UNIV	Other
CHILD & FAMILY RES INST	Other
CHILD HLTH PROGRAM	Other
CHILDRENS HOSP	Other
CHR GRAND PORTAGE	Other
CHRIS HANI BARAGWANATH HOSP	Other
CHRISTIAN MED COLL & HOSP	Other
CHROMA TECHNOL CORP	Other
CHS NATL CANC CONTROL CTR	Other
CHSRF CIHR HLTH SERV	Other
CIRRIS	Other
CIRSE CENT OFF	Other
CLCC GEORGES FRANCOIS LECLERC	Other
CLCC PAUL STRAUSS	Other
CLEAR CANVAS	Other
CLERA INC	Other
CLIN GENOLIER	Other
CLIN JWG UNIV	Other
CLIN MEDELLIN	Other
CLIN NEUROPSYCHOL SERV	Other
CLIN SEMANT GRP	Other
CLIN TRIALS & SURVEYS CORP	Other
CLINCAL & FORENS TOXICOL	Other
CNRS	Other
COGENTECH	Other
COLL MT ST VINCENT	Other
COMBINATORX INC	Other
COMMISS EUROPEAN COMMUNITIES	Other
COMMUNITY HEAD INJURY RESOURCE SERV CHIRS	Other
COMPATH	Other
COMPETENCE CTR SYST PHYSIOL & METAB DIS	Other
COMPREHENS CANC CTR E	Other
COMPREHENS CANC CTR S	Other
CONSEJO SUPER INVEST CIENT	Other
CONSTANTINE PHILOSOPHER UNIV NITRA	Other
CONSTRUCT SAFETY ASSOC	Other
CONSULTANT HLTH RES ETH & POLICY	Other
COOPER UNION ADV SCI & ART	Other
CORBEIL ESSONNES HOSP	Other
COTA HLTH	Other
COURTYARD GRP	Other
CREANUTRITION AG	Other
CRLCC VAL AURELLE	Other
CRUCES HOSP BARAKALDO	Other
CTR ACT PREVENT & READAPTAT INCAPACITE TRAVAIL	Other
CTR ANTOINE LACASSAGNE	Other
CTR BIOL & PATHOL	Other
CTR CLIN	Other
CTR COMMUN CYTOMETRIE FLUX	Other
CTR DIS CONTROL & PREVENT	Other
CTR ESTUDIOS RADIOL INTEGRALES MAMA	Other
CTR ETUD POLYMORPHISME HUMAIN	Other
CTR FRANCOIS BACLESSE	Other
CTR GENET	Other
CTR GERIATR RES EDUC & CLIN	Other
CUNY	Other
DAFRA PHARMA INT	Other
DAIICHI SANKYO CO	Other
DAIICHI SANKYO CO LTD	Other
DEBBIE KATSARELIS	Other
DEBRECEN UNIV MED	Other
DECODE GENET	Other
DELTAQUEST FDN INC	Other
Dennis	Other
DIRECT REG SERV MED ASSURANCE MALAD	Other
DIRECT REGIONALE SERV MED ASSURANCE MALAD	Other
DIRECT SANTE PUBL MONTREAL	Other
DLR	Other
DOE JOINT GENOME INST	Other
DOWN SYNDROME RES FDN	Other
Drutz	Other
DVS SCI INC	Other
DYNACARE KASPER MED LABS	Other
ELAN PHARMACEUT INC	Other
ELLESMERE XRAY & ASSOCIATES	Other
ELLESMERE XRAY ASSOCIATES	Other
EMBL EUROPEAN BIOINFORMAT INST	Other
ENDO PHARMACEUT INC	Other
ENGN SERV INC	Other
EORTC DATA CTR	Other
EPITOMICS INC	Other
EQUIPE ACCUEIL SANTE INDIVIDU SOC	Other
ERASMUS MED CTR	Other
ESH SOFTWARE DESIGN & IMPLEMENTAT LTD	Other
ESTONIAN BIOCTR	Other
EUROPEAN ACAD BOZEN BOLZANO EURAC	Other
EUROPEAN BIOINFORMAT INST	Other
EUROPEAN COMMISS	Other
EUROPEAN HOSP	Other
EUROPEAN MOLEC BIOL LAB	Other
EUROPEAN ORG RES & TREATMENT CANC HEADQUARTERS	Other
EVANGEL KLINIKEN BONN GGMBH	Other
EVANSTON NW HEALTHCARE	Other
EVASC MED SYST	Other
EXPRESS PATHOL INC	Other
FAC MED	Other
FAC MED RTH LAENNEC	Other
FED CTR HLTHCARE KNOWLEDGE KCE	Other
FED MINIST EDUC & RES	Other
FETAL PHYSIOL FDN	Other
FIELD MUSEUM NAT HIST	Other
FINNISH CANC REGISTRY	Other
FIRC INST MOL ONCOL	Other
FLINDERS MED CTR	Other
FOLKHALSAN RES CTR	Other
FORENS EXAMINER TOXICOL	Other
FORSCHUNGSZENTRUM JULICH	Other
FORSYTH INST	Other
FRANKLIN W OLIN COLL ENGN	Other
FRASER HLTH AUTHOR	Other
FRED HUTCHINSON CANC RES CTR	Other
FREE UNIV BRUSSELS	Other
FREIE UNIVARTMENTERSITAT BERLIN	Other
FRIEDRICH MIESCHER INST	Other
FUNDENI CLIN INST	Other
FUTUREHEALTH INC	Other
G GASLINI INST CHILDREN	Other
GAMMA DYNACARE MED LABS	Other
GARTNAVEL ROYAL HOSP	Other
GATSBY COMPUTAT NEUROSCI UNIT	Other
GE HEALTHCARE	Other
GE HEALTHCARE CANADA	Other
GENE BRIDGES GMBH	Other
GENEDX	Other
GENELEX CORP	Other
GENENTECH INC	Other
GENET MED CENT CALIF UCSF	Other
GI FDN S AFRICA	Other
GLADSTONE INST CARDIOVASC DIS	Other
GLAN CLWYD GEN HOSP	Other
GLAXOSMITHKLINE INC	Other
GLENFIELD GEN HOSP	Other
GLOBALSTEM INC	Other
GLOSTRUP HOSP	Other
GLYCAEM INDEX TESTING INC	Other
GLYCEM INDEX LABS	Other
GLYCEM INDEX LABS INC	Other
GLYCEMIC INDEX LABS INC	Other
GOTHENBURG UNIV	Other
GOVT COLL	Other
GOVT INDIA	Other
GRAD DEPT REHABIL SCI	Other
GRAN VIA HOSP	Other
GRAZ TECH UNIV	Other
GREAT ORMOND ST HOSP CHILDREN	Other
GREATER BALTIMORE MED CTR	Other
GREENWOOD GENET CTR	Other
GREY NUNS HOSP	Other
H LEE MOFFITT CANC CTR & RES INST	Other
HAAGLANDEN MC	Other
HAGEDORN RES INST	Other
HAMLINE UNIV	Other
HAMMERSMITH HOSP	Other
HANNAM FERTIL CTR	Other
HARTFORD HOSP	Other
HASKINS LABS INC	Other
HAUKELAND UNIV HOSP	Other
HCSC	Other
HEBREW SENIOR LIFE	Other
HEBREW SENIORLIFE	Other
HEGAU KLINIKUM SINGEN	Other
HELICOS BIOSCI CORP	Other
HELIOS HOSP	Other
HELLEN CTR DIS CONTROL & PREVENT	Other
HELMHOLTZ ZENTRUM MUNCHEN	Other
HENDERSON HOSP	Other
HENNEPIN CTY MED CTR	Other
HENRY FORD HOSP	Other
HINXTON	Other
HIROSAKI UNIV	Other
HOLY NAME HOSP	Other
HOMEWOOD RES INST	Other
HSC PEDIAT CTR	Other
HUDSONALPHA INST BIOTECHNOL	Other
HULL ROYAL INFIRM	Other
HUMAN MATRIX SCI LLC	Other
HUMBER RIVER REG HOSP	Other
HUNTSMAN CANC INST	Other
IATSL	Other
IBARAKI PREFECTURAL HANDICAPPED CHILDRENS CTR	Other
IDIBELL CATALAN INST ONCOL	Other
IEO	Other
IFR	Other
IFR 128	Other
IFR 143	Other
IFR 50	Other
ILLUMINA INC	Other
ILSAN JEIL WOMENS HOSP	Other
IMAGING RES	Other
IMAGING RES CTR	Other
IMAM HOSP	Other
IMGENEX INDIA PVT LTD	Other
IMMUNOPRECISE ANTIBODIES LTD	Other
IMMUNOTEC RES LTD	Other
IN VITRO DRUG SAFETY & BIOTECHNOL	Other
INCOR	Other
IND RES LTD	Other
INOVOBIOL INC	Other
INRA	Other
INSA	Other
INSCEPT BIOSCI	Other
INSERM	Other
INST ADV STUDY	Other
INST AGING RES	Other
INST ANDRE LWOFF	Other
INST BIOCHEM & BIOPHYS	Other
INST BIOCHIM & BIOPHYS MOL & CELLULAIRE	Other
INST BIOINFORMAT	Other
INST BIOMAT & BIOMED ENGN	Other
INST BIOORGAN CHEM NASB	Other
INST CURIE	Other
INST ENTOMOL	Other
INST SPORTS MED	Other
INST SURG RES	Other
INST SYST BIOL	Other
INST UNIV CARDIOL & PNEUMOL QUEBEC	Other
INST VALENCIANO ONCOL	Other
INST WORK & HLTH	Other
INT AGCY RES CANC	Other
INT DIABET INST	Other
INT GENOM CONSORTIUM	Other
INT INST NEUROSCI NATAL EDMOND & LILY SAFRA	Other
INT SOC STEM CELL RES	Other
IRCC	Other
IRCCS	Other
IRCCS FDN	Other
IUF	Other
KRAFT FOODS GLOBAL LLC	Other
LIFE TECHNOL	Other
LIFE TECHNOL CORP	Other
LIFELABS MED LAB SERV	Other
LIFEMARK HLTH MANAGEMENT INC	Other
LIFEQUEST CTR REPROD MED	Other
LILLE UNIV HOSP	Other
Liz	Other
LONDON HLTH SCI CTR	Other
LONDON INDEPENDENT HOSP	Other
LONDON INST	Other
MAKERERE UNIV	Other
MALAGHAN INST MED RES	Other
MALIN SPACE SCI SYST INC	Other
MALLINCKRODT INST RADIOL	Other
MALMSKA MUNICIPAL HLTH CTR & HOSP	Other
MARQUETTE LAW SCH	Other
MARSHFIELD CLIN FDN MED RES & EDUC	Other
MARYLAND PSYCHIAT RES CTR	Other
MARYLAND ZOO	Other
MASARYK MEM CANC INST	Other
MASARYK UNIV	Other
MCTT INC	Other
MDS SCIEX	Other
MED EXAMINER MILWAUKEE CTY	Other
MED FAC ASSOCIATES	Other
MED FAC HOSP	Other
MED NEUROGENET	Other
MED RES INST	Other
MED UNIV	Other
MELLITECH	Other
MENOUFIA UNIV	Other
MENTAL HLTH RES INST VICTORIA	Other
MERCK & CO INC	Other
MICROARRAY CTR	Other
MICROSOFT CORP	Other
MILLIPORE CORP	Other
MILTENYI BIOTEC	Other
MILTENYI BIOTEC GMBH	Other
MIND RES NETWORK	Other
MIND RES NETWORK MRN	Other
MINIST SANTE & SERV SOCIAUX	Other
MINIST SCI & INNOVAT	Other
MISSISSAUGA & GREATER TORONTO AREA	Other
MLF CONSULTING	Other
MOLECULARMD	Other
MRC	Other
NAT & NAT RES JOURNALS	Other
NAT RESOURCES CANADA	Other
NATHAN KLINE INST PSYCHIAT RES NKI	Other
NATHAN S KLINE INST PSYCHIAT RES NKI	Other
NATIONWIDE CHILDRENS HOSP	Other
NATL ACAD SCI	Other
NATL CTR CELL SCI	Other
NATL CTR COMPETENCE RES FRONTIERS GENET	Other
NATL CTR STREPTOCOCCUS	Other
NATL CTR TUMOR DIS	Other
NATL INST BIOL STAND & CONTROL HLTH PROTECT AGCY	Other
NATL INST BIOL STAND & CONTROLS	Other
NATL INST BIOMED GENOM	Other
NATL INST INFECT DIS	Other
NATL INST MED RES	Other
NATL INST NEUROL DISORDERS	Other
NATL INST NEUROSCI	Other
NATL INST NEUROSURG	Other
NATL INST STAND & TECHNOL	Other
NATL INST WELF & HLTH	Other
NATL JEWISH CTR IMMUNOL & RESP MED	Other
NATL LIB MED	Other
NATL MICROBIOL LAB	Other
NATL NAVAL MED CTR	Other
NATL PUBL HLTH INST	Other
NATL PUBL HLTH INST KTL	Other
NATL REHABIL CTR PERSONS DISABIL	Other
NATL RES & DEV CTR WELFARE & HLTH	Other
NATL STARCH LLC	Other
NCI	Other
NCIC CLIN TRIALS GRP	Other
NEI	Other
NHGRI	Other
NHLBI	Other
NHS GRAMPIAN	Other
NIA	Other
NIAAA	Other
NIAID	Other
NIAMS	Other
NICHD	Other
NICOTINE DEPENDENCE CLIN	Other
NIDDK	Other
NIEHS	Other
NIH	Other
NIMH	Other
NINDS	Other
NINR	Other
NIPIGON DIST MEM HOSP	Other
NMVAHCS	Other
NN ALEXANDROV RES INST ONCOL & MED RADIOL	Other
NN BLOKHIN RUSSIAN CANC RES CTR	Other
NN PETROV INST ONCOL	Other
NN PETROV INST RES INST	Other
NN PETROV ONCOL RES INST	Other
NO CALIF CANC CTR	Other
NO ONTARIO SCH MED	Other
NOFER INST OCCUPAT MED	Other
NOVA BIOMED	Other
NOVARTIS INST BIOMED RES	Other
NOVARTIS KNOWLEDGE CTR	Other
NOVARTIS PHARMA AG	Other
NOVARTIS RES FDN	Other
NPS PHARMACEUT INC	Other
NUTR COACHING LLC	Other
NUTRISCI BV	Other
OAS	Other
OBJECT PATHOL SERV	Other
OBRIEN INST	Other
OCCUPAT HLTH CLIN ONTARIO WORKERS INC	Other
OCGN	Other
OICR	Other
OMICIA	Other
OOTA MEM HOSP	Other
OPEN BIOSYST	Other
ORIGENE TECHNOL	Other
ORLA PROT TECHNOL LTD	Other
ORTHOPED UNIV HOSP BALGRIST	Other
OSPED BELCOLLE	Other
OSPED CASA SOLLIEVO SOFFERENZA	Other
OSPED NIGUARDA CA GRANDA	Other
OSPED SAN GIOVANNI BELLINZONA	Other
OSPED SANTA CROCE	Other
OUR LADY LOURDES HOSP	Other
OUR LADY LOURDES MED CTR	Other
OUR LADY LOURDES REG MED CTR	Other
OY FOODFILES LTD	Other
PACIFIC NEPHROL ASSOC	Other
PALACKY UNIV	Other
PALO ALTO HLTH CARE SYST	Other
PARACELSUS MED UNIV	Other
PARI PHARMA GMBH	Other
PARKWOOD HOSP	Other
PCSIR LAB COMPLEX	Other
PENINSULA COLL MED & DENT	Other
PENINSULA MED SCH	Other
PERLEGEN SCI	Other
PETER A SILVERMAN CTR INT HLTH	Other
PFIZER GLOBAL RES & DEV	Other
PFIZER INC	Other
PFIZER PHARMACEUT INC	Other
PHARMA CLIN AG	Other
PHARMAREASONS	Other
PHARMAREASONS PHARMACOL RES & APPL SOLUT	Other
PHARMREASONS	Other
PHSA LABS	Other
PHYS COMM RESPONSIBLE MED	Other
PHYS TECH GESELL RADIOL MBH	Other
PHYSIOMICS PLC	Other
PHYSIOTHERAPY CTR	Other
PISA UNIV HOSP	Other
PIXONIMAGING LLC	Other
PLACENTARY HISTOTHERAPY CTR CHP	Other
PLYMOUTH HOSP NATL HLTH SERV TRUST	Other
PLYMOUTH HOSP NHS TRUST	Other
PLYMOUTH MARINE LAB	Other
POHANG ST MARYS HOSP	Other
POLICLIN A GEMELLI	Other
PONTIFICIA UNIV CATOLICA CHILE	Other
PONTIFICIA UNIV CATOLICA RIO GRANDE DO SUL	Other
PONTIFICIA UNIV JAVERIANA	Other
POTENTIAL GRP	Other
PREDICT MED	Other
PREMUP	Other
PRENATAL DIAG & MED GENET PROGRAM	Other
PRESIDENCY COLL	Other
PRIMARY CHILDRENS MED CTR	Other
PROVLAB	Other
PSC	Other
PSOMA THERAPEUT INC	Other
PUBL HLTH LAB	Other
PUBL POPULAT PROJECT GENOM P3G	Other
PUGET SOUND BLOOD CTR	Other
PURDUE PHARMA	Other
QUINTILES BIOSTAT	Other
RADIA	Other
TALBOT ADVISORS	Other
TERCICA	Other
THERMO FISHER SCI	Other
TMDT	Other
TMDT MARS CTR	Other
TNO QUAL LIFE	Other
TOSHIBA MED SYST	Other
TOSHIBA MED SYST EUROPE BV	Other
TOSHIBA MED SYST GERMANY	Other
TOTAL GAS & POWER	Other
TRANSGEN CORE	Other
TRI SERV GEN HOSP	Other
UFR LEONARD DE VINCI	Other
UJF	Other
UK BIOBANK	Other
ULB	Other
UM2	Other
UPF	Other
USAF	Other
USDA	Other
VAST SCI	Other
VCU HLTH SYST	Other
VM INST RES	Other
VRC	Other
W PK HEALTHCARE CTR	Other
X PRIZE FDN	Other
ADELPHI UNIV	United States
ALABAMA A&M UNIV	United States
ALLIANT INT UNIV	United States
AMER ASSOC ADVANCEMENT SCI	United States
AMER CANC SOC	United States
AMER CHRON PAIN ASSOC	United States
AMER COLL MED GENET	United States
AMER COLL RADIOL	United States
AMER RADIOL SERV	United States
AMER RADIOL SERV INC	United States
AMER TYPE CULTURE COLLECT	United States
AMERICAN UNIV	United States
AMES NATL LAB	United States
AMES RES CTR	United States
ANDREWS UNIV	United States
ANTIOCH UNIV NEW ENGLAND	United States
APPALACHIAN STATE UNIV	United States
ARGONNE NATL LAB	United States
ARIZONA ALZHEIMERS CONSORTIUM	United States
ARIZONA STATE UNIV	United States
ASSOC AMER MED COLL	United States
AUBURN UNIV	United States
AUSTIN HLTH	United States
AUSTIN HOSP	United States
BALL STATE UNIV	United States
BAPTIST CARDIAC & VASC INST	United States
BAPTIST HOSP MIAMI	United States
BARUCH COLL (CUNY)	United States
BAYLOR COLL MED	United States
BAYLOR INST REHABIL	United States
BAYLOR RES INST	United States
BAYLOR SAMMONS CANC CTR	United States
BAYLOR UNIV	United States
BAYSTATE HLTH & TUFTS UNIV	United States
BAYSTATE HLTH SYST	United States
BELLEVUE HOSP CTR	United States
BENAROYA RES INST VIRGINIA MASON	United States
BETH ISRAEL DEACONESS MED CTR	United States
BIOLA UNIV	United States
BIRMINGHAM WOMENS HOSP HEALTHCARE	United States
BIRMINGHAM WOMENS HOSP HEALTHCARE NHS TRUST	United States
BOISE STATE UNIV	United States
BOSTON BIOMED RES INST	United States
BOSTON COLL	United States
BOSTON HEALTHCARE SYST VET AFFAIRS MED CTR	United States
BOSTON SCI	United States
BOSTON UNIV	United States
BOSTON UNIV BIOINFORMAT	United States
BOWLING GREEN STATE UNIV	United States
BRANDEIS UNIV	United States
BRIGHAM YOUNG UNIV	United States
BROAD INST	United States
BROAD INST HARVARD	United States
BROAD INST HARVARD & MIT	United States
BROAD INST MIT & HARVARD	United States
BROOKHAVEN NATL LAB	United States
BROOKLYN COLL (CUNY)	United States
BROWN UNIV	United States
BURNS & ALLEN CEDARS SINAI RES INST	United States
CALIF INST REGENERAT MED	United States
CALIF PACIFIC MED CTR	United States
CALIF STATE UNIV FRESNO	United States
CALIF STATE UNIV FULLERTON	United States
CALIF STATE UNIV LONG BEACH	United States
CALIF STATE UNIV LOS ANGELES	United States
CALIF STATE UNIV NORTHRIDGE	United States
CALIF STATE UNIV SACRAMENTO	United States
CALTECH	United States
CAMBRIDGE CTR	United States
CAMBRIDGE INST MED RES	United States
CAMBRIDGE SYST BIOL CTR	United States
CARLETON COLL	United States
CARMEL HOSP	United States
CARMEL MED CTR & B RAPPAPORT	United States
CARNEGIE INST WASHINGTON	United States
CARNEGIE MELLON UNIV	United States
CASE WESTERN RESERVE UNIV	United States
CATHOLIC UNIV AMER	United States
CEDARS SINAI MED CTR	United States
CENT MICHIGAN UNIV	United States
CHILDRENS HOSP BOSTON	United States
CHILDRENS HOSP PHILADELPHIA	United States
CHILDRENS HOSP PITTSBURGH	United States
CHILDRENS HOSP WESTMEAD	United States
CHILDRENS MEM HLTH INST	United States
CHILDRENS MEM HOSP	United States
CHILDRENS NATL MED CTR	United States
CINCINNATI CHILDRENS HOSP	United States
CINCINNATI CHILDRENS HOSP RES FDN	United States
CITY OF HOPE	United States
CLAREMONT GRAD SCH	United States
CLARK ATLANTA UNIV	United States
CLARK UNIV	United States
CLARKSON UNIV	United States
CLEMSON UNIV	United States
CLEVELAND CLIN CANADA	United States
CLEVELAND CLIN FDN	United States
CLEVELAND CLIN FLORIDA	United States
CLEVELAND CLIN I32	United States
CLEVELAND STATE UNIV	United States
COLD SPRING HARBOR LAB	United States
COLL WILLIAM & MARY	United States
COLORADO SCHOOL MINES	United States
COLORADO STATE UNIV	United States
COLUMBIA UNIV	United States
COLUMBIA UNIV TEACHERS COLL	United States
CORNELL UNIV	United States
CREIGHTON UNIV	United States
CUNY GRAD SCH	United States
CUNY SYSTEM	United States
DANA FABER CANC INST	United States
DANA FARBER CANC CTR	United States
DANA FARBER CANC INST	United States
DARTMOUTH COLL	United States
DE PAUL UNIV	United States
DREXEL UNIV	United States
DUKE UNIV	United States
DUQUESNE UNIV	United States
E CAROLINA UNIV	United States
E TENNESSEE STATE UNIV	United States
EASTERN MICHIGAN UNIV	United States
EDWARD MALLINCKRODT INST RADIOL	United States
EMORY UNIV	United States
EUNICE KENNEDY SHRIVER NATL INST CHILD HLTH & HUM	United States
FAIRFIELD UNIV	United States
FED RESERVE SYSTEM	United States
FERMI NATL ACC LAB	United States
FLORIDA ATLANTIC UNIV	United States
FLORIDA GULF COAST UNIV	United States
FLORIDA INST TECHNOL	United States
FLORIDA INT UNIV	United States
FLORIDA STATE UNIV	United States
FORDHAM UNIV	United States
FOX CHASE CANC CTR	United States
FRED HUTCHINSON CANC CTR	United States
GATES FDN	United States
GEISINGER MED CTR	United States
GEISINGER MED INST	United States
GEISINGER NEUROSCI INST	United States
GEORGE MASON UNIV	United States
GEORGE WASHINGTON UNIV	United States
GEORGETOWN UNIV	United States
GEORGIA INST TECHNOL	United States
GEORGIA SO UNIV	United States
GEORGIA STATE UNIV	United States
GLENN RES CTR	United States
GODDARD SPACE FLIGHT CTR	United States
GRAND VALLEY STATE UNIV	United States
HACKENSACK UNIV	United States
HACKENSACK UNIV MED CTR	United States
HARVARD UNIV	United States
HOFSTRA UNIV	United States
HOWARD UNIV	United States
HUMBOLDT STATE UNIV	United States
HUNTER COLL (CUNY)	United States
IDAHO NATL LAB	United States
IDAHO STATE UNIV	United States
ILLINOIS INST TECHNOL	United States
ILLINOIS STATE UNIV	United States
INDIANA STATE DEPT TOXICOL	United States
INDIANA STATE UNIV	United States
INDIANA UNIV	United States
INDIANA UNIV PENN	United States
INDIANA UNIV PURDUE UNIV	United States
INDIANA UNIV-PURDUE UNIV INDIANAPOLIS	United States
INTER AMER UNIV PUERTO RICO	United States
IOWA CITY VA MED CTR	United States
IOWA STATE UNIV	United States
JACKSON LAB	United States
JACKSON STATE UNIV	United States
JAMES MADISON UNIV	United States
JEFFERSON NATL ACC	United States
JET PROP LAB	United States
JHU APPL PHYS LAB	United States
JJ PETERS VET ADM HOSP	United States
JOHNS HOPKINS ONCOL CTR	United States
JOHNS HOPKINS SCH MED BALTIMORE	United States
JOHNS HOPKINS UNIV	United States
JOHNSON & JOHNSON CONSUMER PROD INC	United States
JOHNSON NUTR SOLUT	United States
JOHNSON SPACE FLIGHT CTR	United States
JOINT CLIN RES CTR	United States
JONSSON COMPREHENS CANC CTR	United States
KANSAS STATE UNIV	United States
KANSAS STATE UNIV AGR & APPL SCI	United States
KENNEDY GALTON CTR	United States
KENNEDY KRIEGER INST	United States
KENNEDY LODGE LONG TERM CARE CTR	United States
KENT STATE UNIV	United States
LAMAR UNIV	United States
LANGLEY RES CTR	United States
LAWRENCE BERKELEY NATL LAB	United States
LAWRENCE LIVERMORE NATL LAB	United States
LEHIGH UNIV	United States
LINCOLN LAB	United States
LOMA LINDA UNIV	United States
LONG ISL JEWISH MED CTR	United States
LONG ISLAND UNIV-BROOKLYN CAMPUS	United States
LOS ALAMOS NATL LAB	United States
LOUISIANA STATE UNIV	United States
LOUISIANA TECH UNIV	United States
LOYOLA MARYMOUNT UNIV	United States
LOYOLA UNIV CHICAGO	United States
MAINE CARDIOL ASSOCIATES	United States
MARINE BIOL LAB	United States
MARQUETTE UNIV	United States
MARSHALL SPACE FLIGHT CTR	United States
MASSACHUSETTS GEN HOSP	United States
MASSACHUSETTS GEN HOSP CHILDREN	United States
MAYO	United States
MAYO CLIN & MAYO FDN	United States
MED COLL GEORGIA	United States
MED COLL WISCONSIN	United States
MED UNIV S CAROLINA	United States
MEM SLOAN KETTERING CANC CTR	United States
MERCER UNIV	United States
METHODIST HOSP	United States
MIAMI CHILDRENS HOSP	United States
MIAMI UNIV	United States
MICHAEL SMITH FDN HLTH RES	United States
MICHIGAN STATE UNIV	United States
MICHIGAN TECHNOL UNIV	United States
MIDDLE TENNESSEE STATE UNIV	United States
MILWAUKEE CTY CIRCUIT COURT BRANCH	United States
MILWAUKEE CTY MED EXAMINERS OFF	United States
MISSISSIPPI STATE UNIV	United States
MISSOURI UNIV SCI & TECHNOL	United States
MIT	United States
MOL DIAGNOST CHILDRENS HOSP WISCONSIN	United States
MONTANA STATE UNIV	United States
MOREHOUSE SCH MED	United States
MT SINAI SCH MED	United States
MT ST VINCENT UNIV	United States
N CAROLINA STATE UNIV	United States
N DAKOTA STATE UNIV FARGO	United States
N SHORE LONG ISL JEWISH HLTH SYST	United States
N SHORE UNIV HLTH SYST	United States
NASA	United States
NATL ENERGY TECH LAB	United States
NATL LOUIS UNIV	United States
NATL RENEWABLE ENERGY LAB	United States
NAVAL RES LAB	United States
NCAR (NATL CTR ATMOSPHERIC RES)	United States
NEW BRUNSWICK LAB	United States
NEW ENGLAND RES INST	United States
NEW JERSEY INST TECHNOL	United States
NEW MEXICO INST MIN TECHNOL	United States
NEW MEXICO STATE UNIV	United States
NEW MEXICO VET AFFAIRS HLTH CARE SYST	United States
NEW SCH SOCIAL RES	United States
NEW YORK MED COLL	United States
NEW YORK PRESBYTERIAN HOSP	United States
NEW YORK STATE CTR EXCELLENCE BIOINFORMAT & LIFE	United States
NEW YORK STATE DEPT HLTH	United States
NEW YORK UNIV	United States
NIST	United States
NO ARIZONA UNIV	United States
NO ILLINOIS UNIV	United States
NOAA (NATL OCEANIC ATMOSPHERIC ADMIN)	United States
NORFOLK & NORWICH UNIV HOSP	United States
NORFOLK & NORWICH UNIV HOSP NATL HLTH SERV TRUST	United States
NORTHEASTERN OHIO UNIV COLL MED & PHARM	United States
NORTHEASTERN UNIV	United States
NORTHSHORE UNIV HEALTHSYST	United States
NORTHSHORE UNIV HLTH SYST	United States
NORTHWESTERN UNIV	United States
NOVA SE UNIV	United States
NW MEM HOSP	United States
NYU HOSP JOINT DIS	United States
OAK RIDGE NATL LAB	United States
OAKLAND UNIV	United States
OHIO STATE UNIV	United States
OHIO UNIV	United States
OKLAHOMA STATE UNIV	United States
OLD DOMINION UNIV	United States
OREGON HLTH SCI UNIV	United States
OREGON STATE UNIV	United States
PACE UNIV	United States
PACIFIC NW LAB	United States
PENN STATE UNIV	United States
PEPPERDINE UNIV	United States
POLYTECH INST NYU	United States
POLYTECH UNIV PUERTO RICO	United States
PONTIFICIAL CATHOLIC UNIV PUERTO RICO	United States
PORTLAND STATE UNIV	United States
PRINCETON PHYSICS LAB	United States
PRINCETON UNIV	United States
PURDUE UNIV	United States
QUEENS COLL NY (CUNY)	United States
RADIOL ASSOCIATES CENT FLORIDA	United States
RADIOL CONSULTANTS FORUM HLTH	United States
REED COLL	United States
RENSSELAER POLYTECH INST	United States
RICE UNIV	United States
ROCHESTER INST TECHNOL	United States
ROCKEFELLER UNIV	United States
RUSH UNIV	United States
RUTGERS STATE UNIV	United States
RUTGERS STATE UNIV NEWARK	United States
S CAROLINA STATE UNIV	United States
S DAKOTA STATE UNIV	United States
SALK INST	United States
SAM HOUSTON STATE UNIV	United States
SAN DIEGO STATE UNIV	United States
SAN FRANCISCO STATE UNIV	United States
SAN JOSE STATE UNIV	United States
SANDIA NATL LAB	United States
SANFORD BURNHAM MED RES INST	United States
SAVANNAH COLL ART & DESIGN	United States
SCRIPPS RES INST	United States
SEATTLE BIOMED RES INST	United States
SEATTLE CHILDRENS HOSP	United States
SEATTLE GENET	United States
SEATTLE RADIOLOGISTS	United States
SETON HALL UNIV	United States
SMITHSONIAN INST	United States
SO ILLINOIS UNIV	United States
SO METHODIST UNIV	United States
SOUTHAMPTON GEN HOSP	United States
ST JOHNS UNIV	United States
ST LOUIS UNIV	United States
STANFORD LIN ACCEL CTR	United States
STANFORD UNIV	United States
STEVENS INST TECHNOL	United States
SUNY ALBANY	United States
SUNY BINGHAMTON	United States
SUNY BUFFALO	United States
SUNY COLL ENV SCI FOREST	United States
SUNY DOWNSTATE MED CTR	United States
SUNY STONY BROOK	United States
SUNY SYSTEM	United States
SUNY UPSTATE MED CTR	United States
SYRACUSE UNIV	United States
TEMPLE UNIV	United States
TENNESSEE STATE UNIV	United States
TEXAS A&M HLTH SCI CTR	United States
TEXAS A&M UNIV	United States
TEXAS A&M UNIV COLLEGE STN	United States
TEXAS A&M UNIV COMMERCE	United States
TEXAS A&M UNIV KINGSVILLE	United States
TEXAS A&M UNIV SYSTEM	United States
TEXAS CHILDRENS HOSP	United States
TEXAS CHRISTIAN UNIV	United States
TEXAS HEART INST	United States
TEXAS MED CTR LIB	United States
TEXAS SCOTTISH RITE HOSP CHILDREN	United States
TEXAS SO UNIV	United States
TEXAS STATE UNIV SAN MARCOS	United States
TEXAS STATE UNIV SYSTEM	United States
TEXAS TECH UNIV	United States
TEXAS TECH UNIV HLTH SCI CTR	United States
TEXAS WOMANS UNIV	United States
THOMAS JEFFERSON UNIV	United States
TUFTS UNIV	United States
TULANE UNIV	United States
UC BERKELEY	United States
UC IRVINE	United States
UC SAN DIEGO	United States
UCL	United States
UNIFORMED SERV UNIV HLTH SCI	United States
UNION INST	United States
UNIV AKRON	United States
UNIV ALABAMA	United States
UNIV ALABAMA BIRMINGHAM	United States
UNIV ALABAMA HUNTSVILLE	United States
UNIV ALABAMA SYSTEM	United States
UNIV ALABAMA TUSCALOOSA	United States
UNIV ALASKA ANCHORAGE	United States
UNIV ALASKA FAIRBANKS	United States
UNIV ARIZONA	United States
UNIV ARKANSAS	United States
UNIV ARKANSAS FAYETTEVILLE	United States
UNIV ARKANSAS LITTLE ROCK	United States
UNIV ARKANSAS MED SCI	United States
UNIV ARKANSAS SYSTEM	United States
UNIV BRIDGEPORT	United States
UNIV CALIF BERKELEY	United States
UNIV CALIF DAVIS	United States
UNIV CALIF IRVINE	United States
UNIV CALIF LOS ANGELES	United States
UNIV CALIF MERCED	United States
UNIV CALIF RIVERSIDE	United States
UNIV CALIF SAN DIEGO	United States
UNIV CALIF SAN FRANCISCO	United States
UNIV CALIF SANTA BARBARA	United States
UNIV CALIF SANTA CRUZ	United States
UNIV CALIF SYSTEM	United States
UNIV CENT FLORIDA	United States
UNIV CHICAGO	United States
UNIV CINCINNATI	United States
UNIV COLORADO BOULDER	United States
UNIV COLORADO DENVER	United States
UNIV COLORADO HLTH SCI CTR	United States
UNIV COLORADO SYSTEM	United States
UNIV CONNECTICUT	United States
UNIV DAYTON	United States
UNIV DELAWARE	United States
UNIV DENVER	United States
UNIV DETROIT MERCY	United States
UNIV FLORIDA	United States
UNIV GEORGIA	United States
UNIV HARTFORD	United States
UNIV HAWAII	United States
UNIV HAWAII MANOA	United States
UNIV HAWAII SYSTEM	United States
UNIV HOUSTON	United States
UNIV IDAHO	United States
UNIV ILLINOIS	United States
UNIV ILLINOIS CHICAGO	United States
UNIV ILLINOIS SPRINGFIELD	United States
UNIV ILLINOIS SYSTEM	United States
UNIV ILLINOIS URBANA-CHAMPAIGN	United States
UNIV IOWA	United States
UNIV KANSAS	United States
UNIV KENTUCKY	United States
UNIV LA VERNE	United States
UNIV LOUISIANA LAFAYETTE	United States
UNIV LOUISVILLE	United States
UNIV MAINE	United States
UNIV MARYLAND	United States
UNIV MARYLAND BALTIMORE COUNTY	United States
UNIV MARYLAND COLLEGE PARK	United States
UNIV MASS AMHERST	United States
UNIV MASS BOSTON	United States
UNIV MASS LOWELL	United States
UNIV MASS SYSTEM	United States
UNIV MASS WORCESTER	United States
UNIV MASSACHUSETTS SYST	United States
UNIV MED	United States
UNIV MED & DENT NEW JERSEY	United States
UNIV MED CTR	United States
UNIV MED CTR II	United States
UNIV MED DENT NEW JERSEY	United States
UNIV MEMPHIS	United States
UNIV MIAMI	United States
UNIV MICHIGAN	United States
UNIV MINNESOTA	United States
UNIV MISSISSIPPI	United States
UNIV MISSOURI	United States
UNIV MISSOURI COLUMBIA	United States
UNIV MISSOURI KANSAS CITY	United States
UNIV MISSOURI ST LOUIS	United States
UNIV MISSOURI SYSTEM	United States
UNIV MONTANA	United States
UNIV N CAROLINA	United States
UNIV N CAROLINA CHAPEL HILL	United States
UNIV N CAROLINA GREENSBORO	United States
UNIV N DAKOTA GRAND FORKS	United States
UNIV N TEXAS DENTON	United States
UNIV N TEXAS HLTH SCI CTR	United States
UNIV N TEXAS SYSTEM	United States
UNIV NEBRASKA	United States
UNIV NEBRASKA LINCOLN	United States
UNIV NEBRASKA OMAHA	United States
UNIV NEBRASKA SYSTEM	United States
UNIV NEVADA	United States
UNIV NEVADA LAS VEGAS	United States
UNIV NEVADA RENO	United States
UNIV NEW HAMPSHIRE	United States
UNIV NEW MEXICO	United States
UNIV NEW ORLEANS	United States
UNIV NO COLORADO	United States
UNIV NORTH CAROLINA CHARLOTTE	United States
UNIV NORTH CAROLINA WILMINGTON	United States
UNIV NOTRE DAME	United States
UNIV OKLAHOMA	United States
UNIV ORANGE FREE STATE	United States
UNIV OREGON	United States
UNIV PACIFIC	United States
UNIV PENN	United States
UNIV PITTSBURGH	United States
UNIV PUERTO RICO	United States
UNIV PUERTO RICO RIO PIEDRAS	United States
UNIV RHODE ISLAND	United States
UNIV ROCHESTER	United States
UNIV S ALABAMA	United States
UNIV S CAROLINA	United States
UNIV S DAKOTA	United States
UNIV S FLORIDA	United States
UNIV SAN DIEGO	United States
UNIV SAN FRANCISCO	United States
UNIV SARASOTA	United States
UNIV SO CALIF	United States
UNIV SO FLORIDA	United States
UNIV SO MISSISSIPPI	United States
UNIV ST THOMAS	United States
UNIV SUNSHINE COAST	United States
UNIV TENNESSEE	United States
UNIV TENNESSEE KNOXVILLE	United States
UNIV TEXAS ARLINGTON	United States
UNIV TEXAS AUSTIN	United States
UNIV TEXAS DALLAS	United States
UNIV TEXAS EL PASO	United States
UNIV TEXAS HLTH SCI CTR HOUSTON	United States
UNIV TEXAS HLTH SCI CTR SAN ANTONIO	United States
UNIV TEXAS MED BRANCH GALVESTON	United States
UNIV TEXAS SAN ANTONIO	United States
UNIV TEXAS SCH PUBLIC HEALTH	United States
UNIV TEXAS SW MED CTR DALLAS	United States
UNIV TOLEDO	United States
UNIV TOLEDO HLTH SCI CAMPUS	United States
UNIV TULSA	United States
UNIV UTAH	United States
UNIV VERMONT	United States
UNIV VIRGINIA	United States
UNIV WASHINGTON	United States
UNIV WASHINGTON SEATTLE	United States
UNIV WISCONSIN	United States
UNIV WISCONSIN MADISON	United States
UNIV WISCONSIN MILWAUKEE	United States
UNIV WISCONSIN PARKSIDE	United States
UNIV WISCONSIN SYSTEM	United States
UNIV WYOMING	United States
UPSTATE MED UNIV SUNY	United States
URBAN HARVEST CIP	United States
URBAN HARVEST CIP SSA	United States
US AIR FORCE	United States
US ARMY	United States
US DEPT DEF	United States
US ENVIRONM PROTECT AGCY DURHAM	United States
US EPA	United States
US FDA	United States
US NATL CANC INST	United States
US NATL INST HLTH	United States
US NAVY	United States
US NCI	United States
USDA (US DEPT AGR)	United States
USN MED ONCOL	United States
UT SOUTHWESTERN MED CTR	United States
UTAH STATE UNIV	United States
UTAH VALLEY REG MED CTR	United States
UTMD ANDERSON CANC CTR	United States
VALPARAISO UNIV	United States
VAMC BOSTON	United States
VANDERBILT UNIV	United States
VILLANOVA UNIV	United States
VIRGINIA COMMONWEALTH UNIV	United States
VIRGINIA POLYTECH INST	United States
W VIRGINIA UNIV	United States
WAKE FOREST UNIV	United States
WALDEN UNIV	United States
WASHBURN UNIV	United States
WASHINGTON CTR CLIN RES	United States
WASHINGTON HOSP	United States
WASHINGTON STATE UNIV	United States
WASHINGTON UNIV	United States
WAYNE STATE UNIV	United States
WEBSTER UNIV	United States
WESTERN MICHIGAN UNIV	United States
WESTERN WASHINGTON UNIV	United States
WHITEHEAD INST	United States
WICHITA STATE UNIV	United States
WIDENER UNIV	United States
WILMINGTON COLL	United States
WOODS HOLE OCEANOG INST	United States
WORCESTER POLYTECH INST	United States
WRIGHT STATE UNIV DAYTON	United States
YALE UNIV	United States
YESHIVA UNIV	United States
YORK COLL NY (CUNY)	United States
UNIV TORONTO	UNIV TORONTO
514 DONNELLY CTR CELLULAR & BIOMOL RES	UNIV TORONTO
BANTING & BEST DEPT MED RES	UNIV TORONTO
BANTING & BEST INST MED RES	UNIV TORONTO
CTR CELLULAR & BIOMOL RES	UNIV TORONTO
CTR CELLULAR & MOLEC BIOL	UNIV TORONTO
DALLA LANA SCH PUBL HLTH	UNIV TORONTO
DONNELLEY CTR	UNIV TORONTO
DONNELLEY CTR CELLULAR & BIOMOL RES	UNIV TORONTO
DONNELLY CTR CELLULAR & BIOMOL RES	UNIV TORONTO
DONNELY CCBR	UNIV TORONTO
TERENCE DONNELLY CTR CELLULAR & BIOMOL RES	UNIV TORONTO
TERRENCE DONNELLY CTR CELLULAR & BIOMOL RES	UNIV TORONTO
DEPT BIOCHEM	UNIV TORONTO
DEPT BIOINFORMAT	UNIV TORONTO
DEPT CELL & SYST BIOL	UNIV TORONTO
DEPT CELL BIOL & BIOPHYS	UNIV TORONTO
DEPT CHEM ENGN & APPL CHEM	UNIV TORONTO
DEPT CLIN GENET	UNIV TORONTO
DEPT DIAGNOST IMAGING	UNIV TORONTO
DEPT ECOL & EVOLUTIONARY BIOL	UNIV TORONTO
DEPT GENET EPIDEMIOL	UNIV TORONTO
DEPT HLTH SCI RES	UNIV TORONTO
DEPT HLTH STUDIES & GERONTOL	UNIV TORONTO
DEPT INTERNAL MED	UNIV TORONTO
DEPT LAB MED	UNIV TORONTO
DEPT LAB MED & PATHOBIOL	UNIV TORONTO
DEPT LAB MED & PATHOL	UNIV TORONTO
DEPT MED BIOPHYS	UNIV TORONTO
DEPT MED GENET	UNIV TORONTO
DEPT MOL & MED GENET	UNIV TORONTO
DEPT MOL GENET	UNIV TORONTO
DEPT NEUROIMAGING	UNIV TORONTO
DEPT NUTR SCI	UNIV TORONTO
DEPT ONCOL & SURG SCI	UNIV TORONTO
DEPT PATHOBIOL	UNIV TORONTO
DEPT PHYS THERAPY REHABIL SCI BLDG	UNIV TORONTO
DEPT PHYSIOL	UNIV TORONTO
DEPT PLAST SURG	UNIV TORONTO
DEPT SURG ONCOL	UNIV TORONTO
DEPT VET AFFAIRS	UNIV TORONTO
UNIV BATNA	Algeria
CONSEJO NACL INVEST CIENT & TECN	Argentina
PONTIFIC CATHOL UNIV ARGENTINA	Argentina
UNIV BUENOS AIRES	Argentina
UNIV CATHOL CORDOBA	Argentina
UNIV NACL CORDOBA	Argentina
UNIV NACL LA PLATA	Argentina
UNIV NACL LITORAL	Argentina
UNIV NACL LOMAS ZAMORA	Argentina
UNIV NACL ROSARIO	Argentina
UNIV NACL SAN LUIS	Argentina
AUSTIN RES INST	Australia
AUSTRALIAN CATHOLIC UNIV	Australia
AUSTRALIAN DEFENSE FORCE ACAD	Australia
AUSTRALIAN NATL UNIV	Australia
BAKER IDI	Australia
BOND UNIV	Australia
CENT QUEENSLAND UNIV	Australia
CHARLES DARWIN UNIV	Australia
CHARLES STURT UNIV	Australia
CHILD MED RES INST	Australia
CSIRO	Australia
CURTIN UNIV TECHNOL	Australia
DEAKIN UNIV	Australia
EDITH COWAN UNIV	Australia
FLINDERS UNIV S AUSTRALIA	Australia
GARVAN INST MED RES	Australia
GRIFFITH UNIV	Australia
HOWARD FLOREY INST	Australia
INST ADV STUDIES	Australia
JAMES COOK UNIV	Australia
LA TROBE UNIV	Australia
LUDWIG INST CANC RES	Australia
MACQUARIE UNIV	Australia
MONASH UNIV	Australia
MURDOCH CHILD RES INST	Australia
MURDOCH UNIV	Australia
PETER MACCALLUM CANC CTR	Australia
QUEENSLAND INST MED RES	Australia
QUEENSLAND UNIV TECHNOL	Australia
RMIT	Australia
SO CROSS UNIV	Australia
SUNSHINE COAST UNIV	Australia
SWINBURNE UNIV TECHNOL	Australia
UNIV ADELAIDE	Australia
UNIV BALLARAT	Australia
UNIV CANBERRA	Australia
UNIV MELBOURNE	Australia
UNIV NEW ENGLAND	Australia
UNIV NEW S WALES	Australia
UNIV NEWCASTLE	Australia
UNIV QUEENSLAND	Australia
UNIV S AUSTRALIA	Australia
UNIV SO QUEENSLAND	Australia
UNIV SYDNEY	Australia
UNIV TASMANIA	Australia
UNIV TECHNOL SYDNEY	Australia
UNIV WESTERN AUSTRALIA	Australia
UNIV WESTERN SYDNEY	Australia
UNIV WOLLONGONG	Australia
VICTORIA UNIV	Australia
WALTER & ELIZA HALL INST	Australia
AUSTRIAN ACAD SCI	Austria
AUSTRIAN RES CTR	Austria
GRAZ UNIV TECHNOL	Austria
INST SCI & TECHNOL	Austria
INT ATOM ENERGY AGCY	Austria
JOHANNES KEPLER UNIV LINZ	Austria
MED UNIV GRAZ	Austria
MED UNIV INNSBRUCK	Austria
MED UNIV VIENNA	Austria
SALZBURG UNIV	Austria
UNIV BODENKULTUR WIEN	Austria
UNIV GRAZ	Austria
UNIV INNSBRUCK	Austria
UNIV KLAGENFURT	Austria
UNIV LEOBEN	Austria
UNIV VET MED VIENNA	Austria
UNIV VIENNA	Austria
VIENNA UNIV ECON & BUSINESS	Austria
VIENNA UNIV TECHNOL	Austria
BAKU STATE UNIV	Azerbaijan
QAFQAZ UNIV	Azerbaijan
BELARUSIAN STATE UNIV	Belarus
CATHOLIC UNIV LEUVEN	Belgium
FREE UNIV BRUSSELS (NOT IDENTIFIED)	Belgium
GHENT UNIV	Belgium
HASSELT UNIV	Belgium
UNIV ANTWERP	Belgium
UNIV CATHOLIQUE LOUVAIN	Belgium
UNIV LIBRE BRUSSELS	Belgium
UNIV LIEGE	Belgium
UNIV MONS	Belgium
UNIV NAMUR	Belgium
VRIJE UNIV BRUSSELS	Belgium
ADOLFO LUTZ INST	Brazil
CTA	Brazil
CTR BRASILEIRO PESQUISAS FIS	Brazil
EMBRAPA	Brazil
FAC MED SAO JOSE DO RIO PRETO	Brazil
FUNDACAO OSWALDO CRUZ	Brazil
HOSP CANC AC CAMARGO	Brazil
HOSP ISRAELITA ALBERT EINSTEIN	Brazil
HOSP SIRIO LIBANES	Brazil
IAC	Brazil
IMPA	Brazil
INST BOT	Brazil
INST BUTANTAN	Brazil
INST DANTE PAZZANESE CARDIOL	Brazil
INST NACL PESQUISAS ESPACIAIS	Brazil
IPEN	Brazil
ITA	Brazil
LAB NACL LUZ SINCROTRON	Brazil
PONTIFIC UNIV CATOL MINAS GERAIS	Brazil
PONTIFIC UNIV CATOL RIO DE JANEIRO	Brazil
PONTIFIC UNIV CATOL RIO GRANDE DO SUL	Brazil
UNIV BRASILIA	Brazil
UNIV CATOL BRASILIA	Brazil
UNIV ESTADO RIO DE JANEIRO	Brazil
UNIV ESTADUAL CAMPINAS	Brazil
UNIV ESTADUAL MARINGA	Brazil
UNIV ESTADUAL PAULISTA	Brazil
UNIV FED ABC	Brazil
UNIV FED ALAGOAS	Brazil
UNIV FED BAHIA	Brazil
UNIV FED CAMPINA GRANDE	Brazil
UNIV FED CEARA	Brazil
UNIV FED FLUMINENSE	Brazil
UNIV FED GOIAS	Brazil
UNIV FED MINAS GERAIS	Brazil
UNIV FED OURO PRETO	Brazil
UNIV FED PARAIBA	Brazil
UNIV FED PARANA	Brazil
UNIV FED PELOTAS	Brazil
UNIV FED PERNAMBUCO	Brazil
UNIV FED RIO DE JANEIRO	Brazil
UNIV FED RIO GRANDE NORTE	Brazil
UNIV FED RIO GRANDE SUL	Brazil
UNIV FED RURAL RIO DE JANEIRO	Brazil
UNIV FED SANTA CATARINA	Brazil
UNIV FED SANTA MARIA	Brazil
UNIV FED SAO CARLOS	Brazil
UNIV FED SAO PAULO	Brazil
UNIV FED UBERLANDIA	Brazil
UNIV FED VICOSA	Brazil
UNIV PRESBITERIANA MACKENZIE	Brazil
UNIV RIBEIRAO PRETO	Brazil
UNIV SAO PAULO	Brazil
UNIV SINOS VALLEY	Brazil
AGRARIAN UNIV	Bulgaria
AGRICULTURAL ACAD	Bulgaria
AMER UNIV BULGARIA	Bulgaria
BULGARIAN ACAD SCI	Bulgaria
MED UNIV PLEVEN	Bulgaria
MED UNIV PLOVDIV	Bulgaria
MED UNIV SOFIA	Bulgaria
MED UNIV VARNA	Bulgaria
MIL ACAD VASIL LEVSKI	Bulgaria
MIL MED ACAD SOFIA	Bulgaria
NAT SPORT ACAD	Bulgaria
NATL ACAD FINE ARTS	Bulgaria
NATL ACAD TEATER & FILM ARTS	Bulgaria
NATL CTR HAEMATOL & TRANSFUSIOL	Bulgaria
NATL SPORTS ACAD	Bulgaria
NATL VET MED INST	Bulgaria
NAVAL ACAD	Bulgaria
NEW BULG UNIV	Bulgaria
PLOVDIV UNIV	Bulgaria
SW UNIV	Bulgaria
TECH UNIV GABROVO	Bulgaria
TECH UNIV PLOVDIV	Bulgaria
TECH UNIV SOFIA	Bulgaria
TECH UNIV VARNA	Bulgaria
THRACIAN UNIV STARA ZAGORA	Bulgaria
TRANSP UNIV	Bulgaria
TSENOV ACAD ECON	Bulgaria
UNIV ARCHITECTURE & CIVIL ENGN	Bulgaria
UNIV BURGAS	Bulgaria
UNIV CHEM TECHNOL & MET	Bulgaria
UNIV ECON VARNA	Bulgaria
UNIV FOOD TECH	Bulgaria
UNIV FORESTRY	Bulgaria
UNIV MIN & GEOL	Bulgaria
UNIV NATL & WORLD ECON	Bulgaria
UNIV RUSE	Bulgaria
UNIV SHUMEN	Bulgaria
UNIV SOFIA	Bulgaria
VARNA FREE UNIV	Bulgaria
VELIKO TARNOVO UNIV	Bulgaria
UNIV YAOUNDE I	Cameroon
EUROPEAN SO OBSERV	Chile
INIA	Chile
PONTIFIC CATHOL UNIV CHILE	Chile
PONTIFIC CATHOL UNIV VALPARAISO	Chile
UNIV ANDES CHILE	Chile
UNIV ANDRES BELLO	Chile
UNIV ANTOFAGASTA	Chile
UNIV ARTURO PRAT	Chile
UNIV ATACAMA	Chile
UNIV AUSTRAL CHILE	Chile
UNIV BIO BIO	Chile
UNIV CATHOL MAULE	Chile
UNIV CATOLICA NORTE	Chile
UNIV CATOLICA TEMUCO	Chile
UNIV CHILE	Chile
UNIV CONCEPCION	Chile
UNIV FRONTERA	Chile
UNIV LAGOS	Chile
UNIV MAGALLANES	Chile
UNIV PLAYA ANCHA	Chile
UNIV SANTIAGO CHILE	Chile
UNIV SANTISIMA CONCEPCION	Chile
UNIV SERENA	Chile
UNIV TALCA	Chile
UNIV TARAPACA	Chile
UNIV TECH FEDERICO SANTA MARIA	Chile
UNIV TECH METROPOLITANA	Chile
UNIV VALPARAISO	Chile
ACAD MIL MED SCI	"China (including HK, Macau)"
ACAD SINICA	"China (including HK, Macau)"
AGR RES INST TAIWAN	"China (including HK, Macau)"
ALETHEIA UNIV	"China (including HK, Macau)"
ANHUI MED UNIV	"China (including HK, Macau)"
ANHUI NORMAL UNIV	"China (including HK, Macau)"
ANHUI UNIV	"China (including HK, Macau)"
BEIHANG UNIV	"China (including HK, Macau)"
BEIJING FORESTRY UNIV	"China (including HK, Macau)"
BEIJING INST TECHNOL	"China (including HK, Macau)"
BEIJING JIAOTONG UNIV	"China (including HK, Macau)"
BEIJING NEUROSURG INST	"China (including HK, Macau)"
BEIJING NORMAL UNIV	"China (including HK, Macau)"
BEIJING UNIV CHEM TECHNOL	"China (including HK, Macau)"
BEIJING UNIV POSTS & TELECOMMUN	"China (including HK, Macau)"
BEIJING UNIV TECHNOL	"China (including HK, Macau)"
CAPITAL MED UNIV	"China (including HK, Macau)"
CAPITAL NORMAL UNIV	"China (including HK, Macau)"
CCAST	"China (including HK, Macau)"
CENT CHINA NORMAL UNIV	"China (including HK, Macau)"
CENT DISEASE CTRL TAIWAN	"China (including HK, Macau)"
CENT IRON & STEEL RES INST	"China (including HK, Macau)"
CENT S UNIV	"China (including HK, Macau)"
CHANG GUNG INST TECHNOL	"China (including HK, Macau)"
CHANG GUNG UNIV	"China (including HK, Macau)"
CHANG JUNG CHRISTIAN UNIV	"China (including HK, Macau)"
CHENGDU UNIV TECHNOL	"China (including HK, Macau)"
CHINA ACAD ENGN PHYS	"China (including HK, Macau)"
CHINA AGR UNIV	"China (including HK, Macau)"
CHINA EARTHQUAKE ADM	"China (including HK, Macau)"
CHINA INST ATOM ENERGY	"China (including HK, Macau)"
CHINA MED UNIV	"China (including HK, Macau)"
CHINA MED UNIV TAIWAN	"China (including HK, Macau)"
CHINA METEOROL ADM	"China (including HK, Macau)"
CHINA PHARMACEUT UNIV	"China (including HK, Macau)"
CHINA UNIV GEOSCI	"China (including HK, Macau)"
CHINA UNIV MIN & TECHNOL	"China (including HK, Macau)"
CHINA UNIV PETR	"China (including HK, Macau)"
CHINESE ACAD AGR SCI	"China (including HK, Macau)"
CHINESE ACAD FORESTRY	"China (including HK, Macau)"
CHINESE ACAD GEOL SCI	"China (including HK, Macau)"
CHINESE ACAD MED SCI PEKING UNION MED CO	"China (including HK, Macau)"
CHINESE ACAD SCI	"China (including HK, Macau)"
CHINESE ACAD SOCIAL SCI	"China (including HK, Macau)"
CHINESE CTR DIS CONTROL & PREVENT	"China (including HK, Macau)"
CHINESE CULTURE UNIV	"China (including HK, Macau)"
CHINESE UNIV HONG KONG	"China (including HK, Macau)"
CHONGQING MED UNIV	"China (including HK, Macau)"
CHONGQING UNIV	"China (including HK, Macau)"
CHONGQING UNIV POSTS & TELECOMMUN	"China (including HK, Macau)"
CHUNG HUA UNIV	"China (including HK, Macau)"
CHUNG SHAN MED UNIV	"China (including HK, Macau)"
CHUNG YUAN CHRISTIAN UNIV	"China (including HK, Macau)"
CITY UNIV HONG KONG	"China (including HK, Macau)"
DA YEH UNIV	"China (including HK, Macau)"
DALIAN MARITIME UNIV	"China (including HK, Macau)"
DALIAN MED UNIV	"China (including HK, Macau)"
DALIAN UNIV TECHNOL	"China (including HK, Macau)"
DAQING PETR INST	"China (including HK, Macau)"
DIWAN COLL MANAGEMENT	"China (including HK, Macau)"
DONGHUA UNIV	"China (including HK, Macau)"
E CHINA INST TECHNOL	"China (including HK, Macau)"
E CHINA NORMAL UNIV	"China (including HK, Macau)"
E CHINA UNIV SCI & TECHNOL	"China (including HK, Macau)"
FENG CHIA UNIV	"China (including HK, Macau)"
FO GUANG UNIV	"China (including HK, Macau)"
FOURTH MIL MED UNIV	"China (including HK, Macau)"
FU JEN CATHOLIC UNIV	"China (including HK, Macau)"
FUDAN UNIV	"China (including HK, Macau)"
FUJIAN MED UNIV	"China (including HK, Macau)"
FUJIAN NORMAL UNIV	"China (including HK, Macau)"
FUZHOU UNIV	"China (including HK, Macau)"
GANSU AGR UNIV	"China (including HK, Macau)"
GEN RES INST NONFERROUS MET	"China (including HK, Macau)"
GUANGDONG UNIV TECHNOL	"China (including HK, Macau)"
GUANGXI NORMAL UNIV	"China (including HK, Macau)"
GUANGXI UNIV	"China (including HK, Macau)"
GUANGZHOU MED COLL	"China (including HK, Macau)"
GUANGZHOU UNIV	"China (including HK, Macau)"
GUIZHOU UNIV	"China (including HK, Macau)"
HANGZHOU DIANZI UNIV	"China (including HK, Macau)"
HANGZHOU NORMAL UNIV	"China (including HK, Macau)"
HARBIN ENGN UNIV	"China (including HK, Macau)"
HARBIN INST TECHNOL	"China (including HK, Macau)"
HARBIN MED UNIV	"China (including HK, Macau)"
HARBIN NORMAL UNIV	"China (including HK, Macau)"
HARBIN UNIV SCI & TECHNOL	"China (including HK, Macau)"
HEBEI MED UNIV	"China (including HK, Macau)"
HEBEI NORMAL UNIV	"China (including HK, Macau)"
HEBEI UNIV	"China (including HK, Macau)"
HEBEI UNIV SCI & TECHNOL	"China (including HK, Macau)"
HEBEI UNIV TECHNOL	"China (including HK, Macau)"
HEFEI UNIV TECHNOL	"China (including HK, Macau)"
HEILONGJIANG UNIV	"China (including HK, Macau)"
HENAN NORMAL UNIV	"China (including HK, Macau)"
HENAN UNIV	"China (including HK, Macau)"
HENAN UNIV SCI & TECHNOL	"China (including HK, Macau)"
HOHAI UNIV	"China (including HK, Macau)"
HONG KONG BAPTIST UNIV	"China (including HK, Macau)"
HONG KONG INST EDUC	"China (including HK, Macau)"
HONG KONG POLYTECH UNIV	"China (including HK, Macau)"
HONG KONG UNIV SCI & TECHNOL	"China (including HK, Macau)"
HSUAN CHUANG UNIV	"China (including HK, Macau)"
HUAFAN UNIV	"China (including HK, Macau)"
HUAQIAO UNIV	"China (including HK, Macau)"
HUAZHONG AGR UNIV	"China (including HK, Macau)"
HUAZHONG UNIV SCI & TECHNOL	"China (including HK, Macau)"
HUBEI NORMAL UNIV	"China (including HK, Macau)"
HUBEI UNIV	"China (including HK, Macau)"
HUNAN NORMAL UNIV	"China (including HK, Macau)"
HUNAN UNIV	"China (including HK, Macau)"
HUNAN UNIV TECHNOL	"China (including HK, Macau)"
I SHOU UNIV	"China (including HK, Macau)"
IND TECHNOL RES INST	"China (including HK, Macau)"
INNER MONGOLIA NORMAL UNIV	"China (including HK, Macau)"
INNER MONGOLIA UNIV	"China (including HK, Macau)"
INST AERONAUT MAT	"China (including HK, Macau)"
INST APPL PHYS & COMPUTAT MATH	"China (including HK, Macau)"
JIANGNAN UNIV	"China (including HK, Macau)"
JIANGSU UNIV	"China (including HK, Macau)"
JIANGXI NORMAL UNIV	"China (including HK, Macau)"
JILIN UNIV	"China (including HK, Macau)"
JINAN UNIV	"China (including HK, Macau)"
JISHOU UNIV	"China (including HK, Macau)"
KAOHSIUNG MED UNIV	"China (including HK, Macau)"
KUNMING MED COLL	"China (including HK, Macau)"
KUNMING UNIV SCI & TECHNOL	"China (including HK, Macau)"
LANZHOU UNIV	"China (including HK, Macau)"
LANZHOU UNIV TECHNOL	"China (including HK, Macau)"
LIAOCHENG UNIV	"China (including HK, Macau)"
LIAONING NORMAL UNIV	"China (including HK, Macau)"
LIAONING SHIHUA UNIV	"China (including HK, Macau)"
LIAONING UNIV	"China (including HK, Macau)"
LINGNAN UNIV	"China (including HK, Macau)"
LUDONG UNIV	"China (including HK, Macau)"
MICROSOFT RES ASIA	"China (including HK, Macau)"
MING CHUAN UNIV	"China (including HK, Macau)"
MINGDAO UNIV	"China (including HK, Macau)"
MINZU UNIV CHINA	"China (including HK, Macau)"
N CHINA ELECT POWER UNIV	"China (including HK, Macau)"
NANCHANG UNIV	"China (including HK, Macau)"
NANHUA UNIV	"China (including HK, Macau)"
NANJING AGR UNIV	"China (including HK, Macau)"
NANJING FORESTRY UNIV	"China (including HK, Macau)"
NANJING MED UNIV	"China (including HK, Macau)"
NANJING NORMAL UNIV	"China (including HK, Macau)"
NANJING UNIV	"China (including HK, Macau)"
NANJING UNIV AERONAUT & ASTRONAUT	"China (including HK, Macau)"
NANJING UNIV SCI & TECHNOL	"China (including HK, Macau)"
NANJING UNIV TECHNOL	"China (including HK, Macau)"
NANKAI UNIV	"China (including HK, Macau)"
NATIONAL INST FOOD & DRUG CONTROL	"China (including HK, Macau)"
NATL APP RES LAB	"China (including HK, Macau)"
NATL CENT UNIV	"China (including HK, Macau)"
NATL CHENG KUNG UNIV	"China (including HK, Macau)"
NATL CHENGCHI UNIV	"China (including HK, Macau)"
NATL CHI NAN UNIV	"China (including HK, Macau)"
NATL CHIAO TUNG UNIV	"China (including HK, Macau)"
NATL CHIAYI UNIV	"China (including HK, Macau)"
NATL CHUNG CHENG UNIV	"China (including HK, Macau)"
NATL CHUNG HSING UNIV	"China (including HK, Macau)"
NATL DEF UNIV	"China (including HK, Macau)"
NATL DONG HWA UNIV	"China (including HK, Macau)"
NATL HLTH RES INST	"China (including HK, Macau)"
NATL KAOHSIUNG UNIV APPL SCI	"China (including HK, Macau)"
NATL RES INST FAMILY PLANNING	"China (including HK, Macau)"
NATL SUN YAT SEN UNIV	"China (including HK, Macau)"
NATL TAICHUNG UNIV	"China (including HK, Macau)"
NATL TAIPEI UNIV	"China (including HK, Macau)"
NATL TAIPEI UNIV TECH	"China (including HK, Macau)"
NATL TAIWAN NORMAL UNIV	"China (including HK, Macau)"
NATL TAIWAN OCEAN UNIV	"China (including HK, Macau)"
NATL TAIWAN UNIV	"China (including HK, Macau)"
NATL TAIWAN UNIV SCI & TECHNOL	"China (including HK, Macau)"
NATL TSING HUA UNIV	"China (including HK, Macau)"
NATL UNIV DEF TECHNOL	"China (including HK, Macau)"
NATL UNIV KAOHSIUNG	"China (including HK, Macau)"
NATL YANG MING UNIV	"China (including HK, Macau)"
NE AGR UNIV	"China (including HK, Macau)"
NE FORESTRY UNIV	"China (including HK, Macau)"
NE NORMAL UNIV	"China (including HK, Macau)"
NINGBO UNIV	"China (including HK, Macau)"
NINGXIA UNIV	"China (including HK, Macau)"
NORTHEASTERN UNIV-CHINA	"China (including HK, Macau)"
NORTHWESTERN POLYTECH UNIV	"China (including HK, Macau)"
NW A&F UNIV	"China (including HK, Macau)"
NW INST NONFERROUS MET RES	"China (including HK, Macau)"
NW INST NUCL TECHNOL	"China (including HK, Macau)"
NW NORMAL UNIV	"China (including HK, Macau)"
NW UNIV XIAN	"China (including HK, Macau)"
OCEAN UNIV CHINA	"China (including HK, Macau)"
PEKING UNIV	"China (including HK, Macau)"
PROVIDENCE UNIV	"China (including HK, Macau)"
QINGDAO UNIV	"China (including HK, Macau)"
QINGDAO UNIV SCI & TECHNOL	"China (including HK, Macau)"
QUFU NORMAL UNIV	"China (including HK, Macau)"
RENMIN UNIV CHINA	"China (including HK, Macau)"
S CHINA AGR UNIV	"China (including HK, Macau)"
S CHINA NORMAL UNIV	"China (including HK, Macau)"
S CHINA UNIV TECHNOL	"China (including HK, Macau)"
SECOND MIL MED UNIV	"China (including HK, Macau)"
SHAANXI NORMAL UNIV	"China (including HK, Macau)"
SHANDONG AGR UNIV	"China (including HK, Macau)"
SHANDONG INST LIGHT IND	"China (including HK, Macau)"
SHANDONG NORMAL UNIV	"China (including HK, Macau)"
SHANDONG UNIV	"China (including HK, Macau)"
SHANDONG UNIV SCI & TECHNOL	"China (including HK, Macau)"
SHANGHAI JIAO TONG UNIV	"China (including HK, Macau)"
SHANGHAI NORMAL UNIV	"China (including HK, Macau)"
SHANGHAI UNIV	"China (including HK, Macau)"
SHANGHAI UNIV SCI & TECHNOL	"China (including HK, Macau)"
SHANTOU UNIV	"China (including HK, Macau)"
SHANXI AGR UNIV	"China (including HK, Macau)"
SHANXI MED UNIV	"China (including HK, Macau)"
SHANXI NORMAL UNIV	"China (including HK, Macau)"
SHANXI UNIV	"China (including HK, Macau)"
SHAOXING COLL ARTS & SCI	"China (including HK, Macau)"
SHENYANG PHARMACEUT UNIV	"China (including HK, Macau)"
SHENYANG UNIV TECHNOL	"China (including HK, Macau)"
SHENZHEN UNIV	"China (including HK, Macau)"
SHIH CHIEN UNIV	"China (including HK, Macau)"
SHIH HSIN UNIV	"China (including HK, Macau)"
SHIJIAZHUANG TIEDAO UNIV	"China (including HK, Macau)"
SICHUAN AGR UNIV	"China (including HK, Macau)"
SICHUAN NORMAL UNIV	"China (including HK, Macau)"
SICHUAN UNIV	"China (including HK, Macau)"
SINOPEC	"China (including HK, Macau)"
SOOCHOW UNIV	"China (including HK, Macau)"
SOUTHEAST UNIV	"China (including HK, Macau)"
SOUTHERN MED UNIV	"China (including HK, Macau)"
SOUTHWEST UNIV	"China (including HK, Macau)"
STATE OCEAN ADM	"China (including HK, Macau)"
SUN YAT SEN UNIV	"China (including HK, Macau)"
SUZHOU UNIV	"China (including HK, Macau)"
SW FORESTRY UNIV	"China (including HK, Macau)"
SW INST PHYS	"China (including HK, Macau)"
SW JIAOTONG UNIV	"China (including HK, Macau)"
SW UNIV FINANCE & ECON	"China (including HK, Macau)"
SW UNIV NATIONALITIES	"China (including HK, Macau)"
SW UNIV POLIT SCI & LAW	"China (including HK, Macau)"
SW UNIV SCI & TECHNOL	"China (including HK, Macau)"
TAIPEI MED UNIV	"China (including HK, Macau)"
TAIWAN FISH RES INST	"China (including HK, Macau)"
TAIWAN LIVESTOCK RES INST	"China (including HK, Macau)"
TAIYUAN UNIV TECHNOL	"China (including HK, Macau)"
TAMKANG UNIV	"China (including HK, Macau)"
TATUNG UNIV	"China (including HK, Macau)"
THIRD MIL MED UNIV	"China (including HK, Macau)"
TIANJIN MED UNIV	"China (including HK, Macau)"
TIANJIN NORMAL UNIV	"China (including HK, Macau)"
TIANJIN POLYTECH UNIV	"China (including HK, Macau)"
TIANJIN UNIV	"China (including HK, Macau)"
TONGJI UNIV	"China (including HK, Macau)"
TSING HUA UNIV	"China (including HK, Macau)"
TUNGHAI UNIV	"China (including HK, Macau)"
TZU CHI UNIV	"China (including HK, Macau)"
UNIV ELECT SCI & TECHNOL CHINA	"China (including HK, Macau)"
UNIV HONG KONG	"China (including HK, Macau)"
UNIV JINAN	"China (including HK, Macau)"
UNIV MACAU	"China (including HK, Macau)"
UNIV SCI & TECHNOL BEIJING	"China (including HK, Macau)"
UNIV SCI & TECHNOL CHINA	"China (including HK, Macau)"
WENZHOU MED COLL	"China (including HK, Macau)"
WENZHOU UNIV	"China (including HK, Macau)"
WUHAN INST TECHNOL	"China (including HK, Macau)"
WUHAN UNIV	"China (including HK, Macau)"
WUHAN UNIV SCI & TECHNOL	"China (including HK, Macau)"
WUHAN UNIV TECHNOL	"China (including HK, Macau)"
XIAMEN UNIV	"China (including HK, Macau)"
XIAN JIAOTONG UNIV	"China (including HK, Macau)"
XIAN MODERN CHEM RES INST	"China (including HK, Macau)"
XIAN UNIV TECHNOL	"China (including HK, Macau)"
XIANGTAN UNIV	"China (including HK, Macau)"
XIDIAN UNIV	"China (including HK, Macau)"
XINJIANG UNIV	"China (including HK, Macau)"
XUZHOU MED COLL	"China (including HK, Macau)"
XUZHOU NORMAL UNIV	"China (including HK, Macau)"
YANBIAN UNIV	"China (including HK, Macau)"
YANGZHOU UNIV	"China (including HK, Macau)"
YANSHAN UNIV	"China (including HK, Macau)"
YANTAI UNIV	"China (including HK, Macau)"
YUAN ZE UNIV	"China (including HK, Macau)"
YUNNAN NORMAL UNIV	"China (including HK, Macau)"
YUNNAN UNIV	"China (including HK, Macau)"
ZHEJIANG ACAD AGR SCI	"China (including HK, Macau)"
ZHEJIANG NORMAL UNIV	"China (including HK, Macau)"
ZHEJIANG UNIV	"China (including HK, Macau)"
ZHEJIANG UNIV TECHNOL	"China (including HK, Macau)"
ZHENGZHOU UNIV	"China (including HK, Macau)"
PONTIFIC UNIV JAVERIANA	Columbia
UNIV ANDES COLOMBIA	Columbia
UNIV DEL NORTE	Columbia
UNIV NACL COLOMBIA	Columbia
INCAE BUSINESS SCH	Costa Rica
INST TECHNOL COSTA RICA	Costa Rica
UNIV COSTA RICA	Costa Rica
CROATIAN ACAD SCI & ARTS	Croatia
NATL & UNIV LIB ZAGREB	Croatia
POLYTECH COLL VELIKA GORICA	Croatia
POLYTECH KARLOVAC	Croatia
POLYTECH RIJEKA	Croatia
POLYTECH VARAZDIN	Croatia
POLYTECH ZAGREB	Croatia
RUDJER BOSKOVIC INST	Croatia
UNIV DUBROVNIK	Croatia
UNIV JJ STROSSMAYER OSIJEK	Croatia
UNIV JURAJ DOBRILA PULA	Croatia
UNIV RIJEKA	Croatia
UNIV SPLIT	Croatia
UNIV ZADAR	Croatia
UNIV ZAGREB	Croatia
ACAD FINE ARTS PRAGUE	Czech Republic
ACAD PERFORMING ARTS PRAGUE	Czech Republic
AGRITEC	Czech Republic
CHARLES UNIV PRAGUE	Czech Republic
CZECH ACAD SCI	Czech Republic
CZECH DAIRY RES INST	Czech Republic
CZECH GEOLOGICAL SURVEY	Czech Republic
CZECH HYDROMETEOROLOGICAL INST	Czech Republic
CZECH METROLOGY INST	Czech Republic
CZECH TECH UNIV PRAGUE	Czech Republic
CZECH UNIV LIFE SCI PRAGUE	Czech Republic
INST CHEM TECHNOL PRAGUE	Czech Republic
INST CRIMINOLOGY	Czech Republic
INST HEMATOLOGY PRAGUE	Czech Republic
MASARYK UNIV BRNO	Czech Republic
MENDEL UNIV BRNO	Czech Republic
NATL LIBRARY PRAGUE	Czech Republic
PALACKY UNIV OLOMOUC	Czech Republic
SILESIAN UNIV OPAVA	Czech Republic
TECH UNIV LIBEREC	Czech Republic
TECH UNIV OSTRAVA	Czech Republic
TOMAS BATA UNIV ZLIN	Czech Republic
UNIV DEFENCE	Czech Republic
UNIV ECON PRAGUE	Czech Republic
UNIV FINANCE & ADMINISTRATION	Czech Republic
UNIV HRADEC KRALOVE	Czech Republic
UNIV JAN EVANGELISTA PURKYNE	Czech Republic
UNIV OSTRAVA	Czech Republic
UNIV PARDUBICE	Czech Republic
UNIV SOUTH BOHEMIA CESKE BUDEJOVICE	Czech Republic
UNIV TECH BRNO	Czech Republic
UNIV VET & PHARMACEUT SCI BRNO	Czech Republic
UNIV W BOHEMIA PILSEN	Czech Republic
VETERINARY RES INST	Czech Republic
AALBORG UNIV	Denmark
AARHUS UNIV	Denmark
COPENHAGEN BUSINESS SCH	Denmark
KOLDING SCHOOL DESIGN	Denmark
ROSKILDE UNIV	Denmark
ROYAL DANISH SCH PHARM	Denmark
ROYAL SCH LIB & INFORMAT SCI	Denmark
TECH UNIV DENMARK	Denmark
UNIV COPENHAGEN	Denmark
UNIV SO DENMARK	Denmark
AIN SHAMS UNIV	Egypt
ALEXANDRIA UNIV	Egypt
AMER UNIV CAIRO	Egypt
ASSIUT UNIV	Egypt
CAIRO UNIV	Egypt
MANSOURA UNIV	Egypt
SO VALLEY UNIV	Egypt
TALLINN TECH UNIV	Estonia
UNIV TARTU	Estonia
AALTO UNIV	Finland
ABO AKADEMI UNIV	Finland
JYVASKYLA UNIV APP SCI	Finland
TAMPERE UNIV TECHNOL	Finland
UNIV EAST FINLAND	Finland
UNIV HELSINKI	Finland
UNIV JYVASKYLA	Finland
UNIV OULU	Finland
UNIV TAMPERE	Finland
UNIV TURKU	Finland
CHRU LILLE	France
ECOLE NATL PONTS & CHAUSSEES	France
ECOLE POLYTECH	France
ENS LYON	France
ENS PARIS	France
EUROPEAN UNIV BRETAGNE	France
HEC PARIS	France
INSEAD BUS SCH	France
INST ETUD POLIT PARIS	France
JOSEPH FOURIER UNIV	France
MINES PARIS TECH	France
NATL INST APP SCI LYON	France
PIERRE & MARIE CURIE UNIV - PARIS 6	France
TOULOUSE BUSINESS SCH	France
UNIV AIX-MARSEILLE	France
UNIV ANGERS	France
UNIV ARTOIS	France
UNIV AUVERGNE	France
UNIV BORDEAUX 1	France
UNIV BOURGOGNE - DIJON	France
UNIV CAEN	France
UNIV CERGY-PONTOISE	France
UNIV CLAUDE BERNARD - LYON 1	France
UNIV FRANCOIS RABELAIS - TOURS	France
UNIV HAUTE BRETAGNE - RENNES 2	France
UNIV HENRI POINCARE - NANCY I	France
UNIV JEAN MOULIN - LYON III	France
UNIV LA ROCHELLE	France
UNIV LE HAVRE	France
UNIV LE MIRAIL - TOULOUSE II	France
UNIV LILLE I	France
UNIV LILLE II	France
UNIV LILLE III	France
UNIV LILLE NORD DE FRANCE	France
UNIV LIMOGES	France
UNIV LITTORAL	France
UNIV LORRAINE	France
UNIV LUMIERE - LYON II	France
UNIV LYON	France
UNIV MAINE - LE MANS	France
UNIV MEDITERRANEAN - AIX-MARSEILLE II	France
UNIV METZ	France
UNIV MICHEL DE MONTAIGNE - BORDEAUX III	France
UNIV MONTPELLIER I	France
UNIV MONTPELLIER II	France
UNIV MONTPELLIER SUD DE FRANCE	France
UNIV NANCY II	France
UNIV NANTERRE - PARIS X	France
UNIV NANTES	France
UNIV NANTES ANGERS LE MANS - UNAM	France
UNIV NICE - SOPHIA ANTIPOLIS	France
UNIV PANTHEON SORBONNE - PARIS I	France
UNIV PARIS 8 VINCENNES-SAINT-DENIS	France
UNIV PARIS DAUPHINE - PARIS IX	France
UNIV PARIS DESCARTES - PARIS V	France
UNIV PARIS DIDEROT - PARIS VII	France
UNIV PARIS II	France
UNIV PARIS NORD - PARIS XIII	France
UNIV PARIS SORBONNE - PARIS IV	France
UNIV PARIS SUD - PARIS XI	France
UNIV PARIS-EST CRETEIL	France
UNIV PAU & PAYS ADOUR	France
UNIV PAUL CEZANNE - AIX-MARSEILLE III	France
UNIV PAUL SABATIER - TOULOUSE III	France
UNIV PAUL VALERY - MONTPELLIER III	France
UNIV PICARDIE-JULES-VERNE	France
UNIV PIERRE MENDES-FRANCE - GRENOBLE II	France
UNIV POITIERS	France
UNIV PROVENCE - AIX-MARSEILLE I	France
UNIV REIMS CHAMPAGNE-ARDENNE	France
UNIV RENNES 1	France
UNIV ROUEN	France
UNIV SCIENCES SOCIALES - TOULOUSE I	France
UNIV SO BRETAGNE	France
UNIV SORBONNE NOUVELLE - PARIS III	France
UNIV STENDHAL - GRENOBLE III	France
UNIV STRASBOURG	France
UNIV SUD TOULON-VAR	France
UNIV VERSAILLES ST-QUENTIN-EN-YVELINES	France
UNIV VICTOR SEGALEN - BORDEAUX II	France
UNIV WEST BRETAGNE	France
BRAUNSCHWEIG UNIV TECHNOL	Germany
CHARITE MED UNIV BERLIN	Germany
DARMSTADT UNIV TECHNOL	Germany
DORTMUND UNIV TECHNOL	Germany
EBERHARD KARLS UNIV TUBINGEN	Germany
EBS UNIV	Germany
FREE UNIV BERLIN	Germany
FRIEDRICH SCHILLER UNIV JENA	Germany
GERMAN CANC RES CTR	Germany
GOETHE UNIV FRANKFURT	Germany
HAMBURG UNIV TECHNOL	Germany
HANNOVER MED SCH	Germany
HEINRICH HEINE UNIV DUSSELDORF	Germany
HELMHOLTZ ASSOCIATION	Germany
HUMBOLDT UNIV BERLIN	Germany
JOHANNES GUTENBERG UNIV MAINZ	Germany
JULICH RES CTR	Germany
JUSTUS LIEBIG UNIV GIESSEN	Germany
KARLSRUHE INST TECHNOL	Germany
MARTIN LUTHER UNIV HALLE WITTENBERG	Germany
MAX PLANCK SOCIETY	Germany
PHILIPPS UNIV MARBURG	Germany
RUHR UNIV BOCHUM	Germany
RUPRECHT KARL UNIV HEIDELBERG	Germany
RWTH AACHEN UNIV	Germany
SAARLAND UNIV	Germany
TECH UNIV BERLIN	Germany
TECH UNIV DRESDEN	Germany
TECH UNIV MUNICH	Germany
UNIV AUGSBURG	Germany
UNIV BAYREUTH	Germany
UNIV BIELEFELD	Germany
UNIV BONN	Germany
UNIV BREMEN	Germany
UNIV COLOGNE	Germany
UNIV DUISBURG ESSEN	Germany
UNIV ERLANGEN NUREMBERG	Germany
UNIV FREIBURG	Germany
UNIV GOTTINGEN	Germany
UNIV HAMBURG	Germany
UNIV HANNOVER	Germany
UNIV KAISERSLAUTERN	Germany
UNIV KIEL	Germany
UNIV KONSTANZ	Germany
UNIV LEIPZIG	Germany
UNIV MANNHEIM	Germany
UNIV MUNICH	Germany
UNIV MUNSTER	Germany
UNIV POTSDAM	Germany
UNIV REGENSBURG	Germany
UNIV ROSTOCK	Germany
UNIV STUTTGART	Germany
UNIV ULM	Germany
UNIV WURZBURG	Germany
GHANA HLTH SERV	Ghana
KUMASI CTR COLLABORAT RES	Ghana
KWAME NKRUMAH UNIV SCI & TECHNOL	Ghana
NAVRONGO HLTH RES CTR	Ghana
NOGUCHI MEM INST MED RES	Ghana
UNIV CAPE COAST	Ghana
UNIV GHANA	Ghana
AGR UNIV ATHENS	Greece
ARISTOTLE UNIV THESSALONIKI	Greece
ASPETE SCH PEDAG & TECHNOL EDUC	Greece
ATHENS MED SCH	Greece
ATHENS SCH FINE ARTS	Greece
ATHENS UNIV ECON & BUSINESS	Greece
DEMOCRITUS UNIV THRACE	Greece
FORTH	Greece
HAROKOPIO UNIV ATHENS	Greece
HELLEN OPEN UNIV	Greece
INT HELLEN UNIV	Greece
IONIAN UNIV	Greece
NATL TECH UNIV ATHENS	Greece
PANTEION UNIV	Greece
TECH UNIV CRETE	Greece
UNIV AEGEAN	Greece
UNIV ATHENS	Greece
UNIV CENT GREECE	Greece
UNIV CRETE	Greece
UNIV CYPRUS	Greece
UNIV IOANNINA	Greece
UNIV MACEDONIA	Greece
UNIV PATRAS	Greece
UNIV PELOPONNESE	Greece
UNIV PIRAEUS	Greece
UNIV THESSALY	Greece
UNIV WESTERN MACEDONIA	Greece
BUDAPEST UNIV TECHNOL & ECON	Hungary
CENT EUROPEAN UNIV	Hungary
CORVINUS UNIV BUDAPEST	Hungary
EOTVOS LORAND UNIV	Hungary
HUNGARIAN ACAD SCI	Hungary
KAPOSVAR UNIV	Hungary
OBUDA UNIV	Hungary
SEMMELWEIS UNIV	Hungary
SZEGED UNIV	Hungary
SZENT ISTVAN UNIV	Hungary
UNIV DEBRECEN	Hungary
UNIV ISTVAN SZECHENYI	Hungary
UNIV MISKOLC	Hungary
UNIV PANNONIA	Hungary
UNIV PECS	Hungary
UNIV W HUNGARY	Hungary
LANDSPITALI NATL	Iceland
REYKJAVIK UNIV	Iceland
UNIV ICELAND	Iceland
AGHARKAR RES INST	India
ALIGARH MUSLIM UNIV	India
ALL INDIA INST MED SCI	India
AMITY UNIV	India
ANDHRA UNIV	India
ANNA UNIV	India
ANNA UNIV CHENNAI	India
ANNA UNIV TECHNOL CHENNAI	India
ANNA UNIV TECHNOL COIMBATORE	India
ANNA UNIV TECHNOL MADURAI	India
ANNA UNIV TECHNOL TIRUCHIRAPPALLI	India
ANNA UNIV TECHNOL TIRUNELVELI	India
ARYABHATTA RES INST OBSERVAT SCI	India
AVINASHILINGAM UNIV WOMEN	India
BANARAS HINDU UNIV	India
BANGALORE UNIV	India
BHABHA ATOM RES CTR	India
BHARATHIAR UNIV	India
BHARATHIDASAN UNIV	India
BIRLA INST TECHNOL & SCI	India
BOSE INST	India
CMCH VELLORE	India
CSIR INDIA	India
CSIR REG RES LAB	India
CTR CELLULAR & MOL BIOL	India
CTR ELECT ENGN RES INST	India
CTR ELECTROCHEM RES INST	India
CTR FOOD TECHNOL RES INST	India
CTR GLASS & CERAM RES INST	India
CTR INST MED & AROMAT PLANTS	India
CTR INST MIN & FUEL RES	India
CTR LEATHER RES INST	India
CTR MATH MODELING & COMP SIMULAT	India
CTR SALT & MARINE CHEM RES INST	India
DEVI AHILYA UNIV	India
DR D Y PATIL VIDYAPEETH PUNE	India
ENGLISH & FOREIGN LANG UNIV	India
GGS INDRAPRASTHA UNIV	India
GUJARAT UNIV	India
IACS JADAVPUR	India
IISC BANGLORE	India
IIT	India
IIT BOMBAY	India
IIT DELHI	India
IIT GUWAHATI	India
IIT KANPUR	India
IIT KHARAGPUR	India
IIT MADRAS	India
IIT ROORKEE	India
IND TOXICOL RES CTR	India
INDIAN AGR RES INST	India
INDIAN ASSOC CULTIVAT SCI	India
INDIAN COUNCIL MED RES	India
INDIAN INST CHEM BIOL	India
INDIAN INST CHEM TECHNOL	India
INDIAN INST GEOMAGNETISM	India
INDIAN INST INTEGRAT MED	India
INDIAN INST PETR	India
INDIAN NATL ACAD ENGN	India
INDIAN NATL SCI ACAD	India
INDIAN STAT INST	India
INDIAN VET RES INST	India
INDIRA GANDHI CTR ATOM RES	India
INST ADV STUDY SCI & TECHNOL	India
INST HIMALAYAN BIORESOURCE TECHNOL	India
INST MICROBIAL TECHNOL	India
ITM UNIV	India
JADAVPUR UNIV	India
JAMIA HAMDARD UNIV	India
JAMIA MILLIA ISLAMIA	India
JAWAHARLAL NEHRU CTR ADV SCI RES	India
JAWAHARLAL NEHRU UNIV	India
JIWAJI UNIV	India
LOVELY PROFESSIONAL UNIV	India
LOYOLA COLL	India
MAHARAJA SAYAJIRAO UNIV BARODA	India
MAHARSHI DAYANAND UNIV	India
MAHATMA GANDHI UNIV	India
MANIPAL UNIV	India
MANIPUR UNIV	India
MAULANA AZAD MED COLL	India
MOTHER TERESA WOMENS UNIV	India
N BENGAL UNIV	India
NAGPUR UNIV	India
NATL AEROSP LABS	India
NATL BOT RES INST	India
NATL CHEM LAB PUNE	India
NATL ENVIRONM ENGN RES INST	India
NATL GEOPHYS RES INST	India
NATL INST INTERDISCIPLINARY SCI & TECHNOL	India
NATL INST MENTAL HLTH NEUROSCI	India
NATL INST OCEANOG	India
NATL INST SCI COMMUN & INFORMAT RESOURCES	India
NATL INST SCI TECHNOL & DEV STUDIES	India
NATL INST TECHNOL KARNATAKA	India
NATL MET LAB	India
NATL PHYS LAB - INDIA	India
NE HILL UNIV	India
ORISSA UNIV AGR TECHNOL	India
OSMANIA UNIV	India
PANJABI UNIV	India
PGIMER CHANDIGARH	India
PHYS RES LAB	India
PONDICHERRY UNIV	India
POSTGRAD INST MED EDUC RES	India
PRESIDENCY COLL	India
PUNJAB UNIV	India
RAJASTHAN AGR UNIV	India
RAVISHANKAR UNIV	India
REG ENGN COLL	India
SARDAR PATEL UNIV	India
SHIVAJI UNIV	India
SN BOSE NATL CTR BASIC SCI	India
SREE CHITRA TIRUNAL INST MED SCI TECHNOL	India
SRI VENKATESWARA UNIV	India
ST STEPHENS COLL	India
STRUCT ENGINEERING RES CTR	India
TAMIL NADU VET & ANIMAL SCI UNIV	India
TATA INST FUND RES	India
TATA INST SOCIAL SCI	India
TEZPUR UNIV	India
THAPAR UNIV	India
UNIV ALLAHABAD	India
UNIV CALCUTTA	India
UNIV CALICUT	India
UNIV DELHI	India
UNIV HYDERABAD	India
UNIV JAMMU	India
UNIV KERALA	India
UNIV LUCKNOW	India
UNIV MADRAS	India
UNIV MUMBAI	India
UNIV PUNE	India
WADIA INST HIMALAYAN GEOL	India
GADJAH MADA UNIV	Indonesia
UNIV INDONESIA	Indonesia
AMIRKABIR UNIV TECHNOL	Iran
IMMUNOL ASTHMA & ALLERGY RES INST	Iran
ISFAHAN UNIV TECHNOL	Iran
SHARIF UNIV TECHNOL	Iran
SHIRAZ UNIV	Iran
TEHRAN UNIV MED SCI	Iran
UNIV TEHRAN	Iran
DUBLIN CITY UNIV	Ireland
DUBLIN INST TECHNOL	Ireland
NUI GALWAY	Ireland
NUI MAYNOOTH	Ireland
ROYAL COLL SURGEONS IRELAND	Ireland
TRINITY COLL DUBLIN	Ireland
UNIV COLL CORK	Ireland
UNIV COLL DUBLIN	Ireland
UNIV LIMERICK	Ireland
BAR ILAN UNIV	Israel
BEN GURION UNIV	Israel
HEBREW UNIV JERUSALEM	Israel
IDC HERZLIYA	Israel
TECHNION ISRAEL INST TECHNOL	Israel
TEL AVIV UNIV	Israel
UNIV HAIFA	Israel
WEIZMANN INST SCI	Israel
BOCCONI UNIV	Italy
CATHOLIC UNIV SACRED HEART	Italy
CNR	Italy
IST NAZL FIS NUCL	Italy
IST NAZL TUMORI	Italy
LUISS GUIDO CARLI UNIV	Italy
MARCHE POLYTECH UNIV	Italy
NATL INST CANC RES	Italy
POLYTECH UNIV MILAN	Italy
POLYTECH UNIV TURIN	Italy
ROMA TRE UNIV	Italy
SAPIENZA UNIV ROME	Italy
SCUOLA NORMALE SUPER PISA	Italy
TELETHON	Italy
UNIV AQUILA	Italy
UNIV BARI	Italy
UNIV BOLOGNA	Italy
UNIV CA FOSCARI VENEZIA	Italy
UNIV CALABRIA	Italy
UNIV CAMPUS BIOMED	Italy
UNIV CATANIA	Italy
UNIV FERRARA	Italy
UNIV FLORENCE	Italy
UNIV FOGGIA	Italy
UNIV GENOA	Italy
UNIV MESSINA	Italy
UNIV MILAN	Italy
UNIV MILANO-BICOCCA	Italy
UNIV MODENA & REGGIO EMILIA	Italy
UNIV MOLISE	Italy
UNIV NAPLES FEDERICO II	Italy
UNIV PADUA	Italy
UNIV PALERMO	Italy
UNIV PARMA	Italy
UNIV PAVIA	Italy
UNIV PERUGIA	Italy
UNIV PISA	Italy
UNIV ROME TOR VERGATA	Italy
UNIV SALENTO	Italy
UNIV SALERNO	Italy
UNIV SIENA	Italy
UNIV TRENTO	Italy
UNIV TRIESTE	Italy
UNIV TURIN	Italy
UNIV UDINE	Italy
UNIV VERONA	Italy
UNIV TECHNOL	Jamaica
UNIV WEST INDIES	Jamaica
AICHI CANC CTR	Japan
AICHI GAKUIN UNIV	Japan
AICHI MED UNIV	Japan
AIST	Japan
AKITA UNIV	Japan
AOYAMA GAKUIN UNIV	Japan
ASAHI UNIV	Japan
ASAHIKAWA MED COLL	Japan
AZABU UNIV	Japan
CENT RES INST ELECT POWER IND	Japan
CHIBA INST TECHNOL	Japan
CHIBA UNIV	Japan
CHUBU UNIV	Japan
CHUO UNIV	Japan
DOKKYO UNIV	Japan
DOSHISHA UNIV	Japan
EHIME UNIV	Japan
FISHERIES RES AGCY	Japan
FORESTRY & FOREST PROD RES INST	Japan
FUJITA HLTH UNIV	Japan
FUKUOKA UNIV	Japan
FUKUSHIMA MED UNIV	Japan
FUKUSHIMA UNIV	Japan
FUKUYAMA UNIV	Japan
GAKUSHUIN UNIV	Japan
GIFU PHARMACEUT UNIV	Japan
GIFU UNIV	Japan
GRAD UNIV ADV STUDIES	Japan
GUNMA UNIV	Japan
HAMAMATSU UNIV SCH MED	Japan
HIROSAKI UNIV	Japan
HIROSHIMA UNIV	Japan
HITOTSUBASHI UNIV	Japan
HLTH SCI UNIV HOKKAIDO	Japan
HOKKAIDO UNIV	Japan
HOKURIKU UNIV	Japan
HOSEI UNIV	Japan
HOSHI UNIV	Japan
HYOGO COLL MED	Japan
IBARAKI UNIV	Japan
INST METROPOLITAN SCI MED	Japan
INST MOL SCI	Japan
ISTEC	Japan
IWATE MED UNIV	Japan
IWATE UNIV	Japan
JAMSTEC	Japan
JAPAN ADV INST SCI & TECHNOL	Japan
JAPAN ATOM ENERGY AGCY	Japan
JAPAN SYNCHROTRON RADIAT RES INST	Japan
JAPANESE FDN CANC RES	Japan
JAXA	Japan
JICHI MED UNIV	Japan
JIKEI UNIV	Japan
JOSAI UNIV	Japan
JST	Japan
JUNTENDO UNIV	Japan
KAGAWA UNIV	Japan
KAGOSHIMA UNIV	Japan
KANAGAWA DENT COLL	Japan
KANAGAWA UNIV	Japan
KANAZAWA INST TECHNOL	Japan
KANAZAWA MED UNIV	Japan
KANAZAWA UNIV	Japan
KANSAI MED UNIV	Japan
KANSAI UNIV	Japan
KAWASAKAI MED SCH	Japan
KEIO UNIV	Japan
KEK	Japan
KINKI UNIV	Japan
KITAMI INST TECHNOL	Japan
KITASATO UNIV	Japan
KOBE GAKUIN UNIV	Japan
KOBE PHARMACEUT UNIV	Japan
KOBE UNIV	Japan
KOCHI UNIV	Japan
KOGAKUIN UNIV	Japan
KONAN UNIV	Japan
KUMAMOTO UNIV	Japan
KURUME UNIV	Japan
KWANSEI GAKUIN UNIV	Japan
KYORIN UNIV	Japan
KYOTO INST TECHNOL	Japan
KYOTO PHARMACEUT UNIV	Japan
KYOTO PREFECTURAL UNIV	Japan
KYOTO PREFECTURAL UNIV MED	Japan
KYOTO UNIV	Japan
KYUSHU INST TECHNOL	Japan
KYUSHU UNIV	Japan
MEIJI PHARMACEUT UNIV	Japan
MEIJI UNIV	Japan
MEIJO UNIV	Japan
MEIKAI UNIV	Japan
METEOROL RES INST	Japan
MIE UNIV	Japan
MINIST AGR FORESTRY & FISHERIES	Japan
MUKOGAWA WOMENS UNIV	Japan
MURORAN INST TECHNOL	Japan
NAGAOKA UNIV TECHNOL	Japan
NAGASAKI UNIV	Japan
NAGOYA CITY UNIV	Japan
NAGOYA INST TECHNOL	Japan
NAGOYA UNIV	Japan
NARA INST SCI & TECHNOL	Japan
NARA MED UNIV	Japan
NARA WOMENS UNIV	Japan
NATL AGR RES CTR	Japan
NATL ASTRON OBSERV	Japan
NATL CEREBRAL & CARDIOVASC CTR	Japan
NATL CTR CHILD HLTH DEV	Japan
NATL CTR GLOBAL HLTH & MED	Japan
NATL CTR NEUROL & PSYCHIAT	Japan
NATL DEF ACAD	Japan
NATL DEF MED COLL	Japan
NATL FOOD RES INST	Japan
NATL INST AGROBIOL SCI	Japan
NATL INST AGROENVIRONM SCI	Japan
NATL INST ANIM HLTH	Japan
NATL INST BASIC BIOL	Japan
NATL INST ENVIRONM STUDIES	Japan
NATL INST FUS SCI	Japan
NATL INST GENET	Japan
NATL INST HLTH & NUTR	Japan
NATL INST HLTH SCI	Japan
NATL INST PHYSIOL SCI	Japan
NATL INST RADIOL SCI	Japan
NICT	Japan
NIHON UNIV	Japan
NIIGATA UNIV	Japan
NIMS	Japan
NIPPON DENT UNIV	Japan
NIPPON MED SCH	Japan
NIPPON VET & LIFE SCI UNIV	Japan
OBIHIRO UNIV AGR & VET MED	Japan
OCHANOMIZU UNIV	Japan
OITA UNIV	Japan
OKAYAMA UNIV	Japan
OKAYAMA UNIV SCI	Japan
OSAKA CITY UNIV	Japan
OSAKA ELECTROCOMMUN UNIV	Japan
OSAKA INST TECHNOL	Japan
OSAKA MED COLL	Japan
OSAKA MED CTR CANC & CARDIOVASC DIS	Japan
OSAKA PREFECTURE UNIV	Japan
OSAKA UNIV	Japan
OSAKA UNIV EDUC	Japan
OSAKA UNIV PHARMACEUT SCI	Japan
RADIAT EFFECTS RES FDN	Japan
RAKUNO GAKUEN UNIV	Japan
RIKEN	Japan
RIKKYO UNIV	Japan
RITSUMEIKAN UNIV	Japan
SAGA UNIV	Japan
SAITAMA MED UNIV	Japan
SAITAMA UNIV	Japan
SAPPORO MED UNIV	Japan
SETSUNAN UNIV	Japan
SHIBAURA INST TECHNOL	Japan
SHIGA UNIV	Japan
SHIGA UNIV MED SCI	Japan
SHIMANE UNIV	Japan
SHINSHU UNIV	Japan
SHIZUOKA UNIV	Japan
SHOWA UNIV	Japan
SOPHIA UNIV	Japan
ST MARIANNA UNIV	Japan
TEIKYO UNIV	Japan
TOHO UNIV	Japan
TOHOKU PHARMACEUT UNIV	Japan
TOHOKU UNIV	Japan
TOKAI UNIV	Japan
TOKUSHIMA BUNRI UNIV	Japan
TOKYO CITY UNIV	Japan
TOKYO DENKI UNIV	Japan
TOKYO DENT COLL	Japan
TOKYO GAKUGEI UNIV	Japan
TOKYO INST PSYCHIAT	Japan
TOKYO INST TECHNOL	Japan
TOKYO MED & DENT UNIV	Japan
TOKYO MED UNIV	Japan
TOKYO METROPOLITAN INST GERONTOL	Japan
TOKYO METROPOLITAN INST MED SCI	Japan
TOKYO METROPOLITAN INST NEUROSCI	Japan
TOKYO METROPOLITAN INST PUBL HLTH	Japan
TOKYO METROPOLITAN UNIV	Japan
TOKYO UNIV AGR	Japan
TOKYO UNIV AGR & TECHNOL	Japan
TOKYO UNIV MARINE SCI & TECHNOL	Japan
TOKYO UNIV PHARM & LIFE SCI	Japan
TOKYO UNIV SCI	Japan
TOKYO WOMENS MED UNIV	Japan
TOTTORI UNIV	Japan
TOYAMA UNIV	Japan
TOYOHASHI UNIV TECHNOL	Japan
TOYOTA TECHNOL INST	Japan
UNIV ELECTROCOMMUN	Japan
UNIV FUKUI	Japan
UNIV HYOGO	Japan
UNIV MIYAZAKI	Japan
UNIV OCCUPAT & ENVIRONM HLTH	Japan
UNIV RYUKYUS	Japan
UNIV SHIZUOKA	Japan
UNIV TOKUSHIMA	Japan
UNIV TOKYO	Japan
UNIV TSUKUBA	Japan
UNIV YAMANASHI	Japan
UTSUNOMIYA UNIV	Japan
WAKAYAMA MED UNIV	Japan
WAKAYAMA UNIV	Japan
WASEDA UNIV	Japan
YAMAGATA UNIV	Japan
YAMAGUCHI UNIV	Japan
YOKOHAMA CITY UNIV	Japan
YOKOHAMA NATL UNIV	Japan
JORDAN UNIV SCI & TECHNOL	Jordan
UNIV JORDAN	Jordan
ACAD PUBLIC ADMIN	Kazakhstan
AL-FARABI KAZAKH NATL UNIV	Kazakhstan
ASTANA MED UNIV	Kazakhstan
EA BUKETOV KARAGANDA STATE UNIV	Kazakhstan
KAZAKH BRITISH TECH UNIV	Kazakhstan
KAZAKH NATL PEDAGOGICAL UNIV	Kazakhstan
KAZAKH NATL TECH UNIV	Kazakhstan
KOKSHETAU STATE UNIV	Kazakhstan
L.N. GUMILYOV EURASIAN NATL UNIV	Kazakhstan
M.AUEZOV SOUTH KAZAKH STATE UNIV	Kazakhstan
NATL ACAD SCI KAZAKHSTAN	Kazakhstan
UNIV NAIROBI	Kenya
GULF UNIV SCI & TECHNOL	Kuwait
KUWAIT INST SCI RES	Kuwait
KUWAIT UNIV	Kuwait
PAAET	Kuwait
RIGA STRADINS UNIV	Latvia
RIGA TECH UNIV	Latvia
TRANSPORT & TELECOM INST	Latvia
UNIV LATVIA	Latvia
AMERICAN UNIV BEIRUT	Lebanon
BEIRUT MED CTR	Lebanon
KAUNAS UNIV TECHNOL	Lithuania
VILNIUS UNIV	Lithuania
UNIV MALAWI	Malawi
AGENSI NUKLEAR MALAYSIA	Malaysia
CURTIN UNIV TECHNOL SARAWAK	Malaysia
INST JANTUNG NEGARA	Malaysia
INST PENYELIDIKAN DAN KEMAJUAN PERTANIAN	Malaysia
INST PENYELIDIKAN GETAH MALAYSIA	Malaysia
INST PENYELIDIKAN HAIWAN	Malaysia
INST PENYELIDIKAN PERHUTANAN MALAYSIA	Malaysia
INST PENYELIDIKAN PERUBATAN	Malaysia
INTL ISLAMIC UNIV MALAYSIA	Malaysia
JABATAN HUTAN SARAWAK	Malaysia
KEMENTERIAN KESIHATAN MALAYSIA	Malaysia
MALAYSIAN PALM OIL BOARD	Malaysia
MALAYSIAN RUBBER BOARD	Malaysia
MONASH UNIV SUNWAY	Malaysia
MULTIMEDIA UNIV	Malaysia
PUSAT PENYELIDIKAN HUTAN	Malaysia
SIRIM BERHAD	Malaysia
SWINBURNE UNIV TECHNOL SARAWAK	Malaysia
UNIV AIMST	Malaysia
UNIV ISLAM ANTARABANGSA MALAYSIA	Malaysia
UNIV KEBANGSAAN MALAYSIA	Malaysia
UNIV KUALA LUMPUR	Malaysia
UNIV MALAYA	Malaysia
UNIV MALAYSIA PERLIS	Malaysia
UNIV MALAYSIA SABAH	Malaysia
UNIV MALAYSIA SARAWAK	Malaysia
UNIV MALAYSIA TERENGGANU	Malaysia
UNIV NOTTINGHAM MALAYSIA	Malaysia
UNIV PERUBATAN ANTARABANGSA	Malaysia
UNIV PUTRA MALAYSIA	Malaysia
UNIV SAINS MALAYSIA	Malaysia
UNIV TEKNOL MALAYSIA	Malaysia
UNIV TEKNOL MARA	Malaysia
UNIV TEKNOL PETRONAS	Malaysia
UNIV TENAGA NASIONAL	Malaysia
UNIV TUN HUSSEIN ONN MALAYSIA	Malaysia
UNIV TUNKU ABDUL RAHMAN	Malaysia
UNIV UTARA MALAYSIA	Malaysia
BENEMERITA UNIV AUTONOMA PUEBLA	Mexico
COLEGIO POSTGRAD	Mexico
COLL MEXICO	Mexico
INST MEXICANO PETR	Mexico
MONTERREY INST TECH & HIGHER EDUC	Mexico
NATL AUTONOMOUS UNIV MEXICO	Mexico
NATL POLYTECH INST	Mexico
NTL AUTONOMOUS UNIV MEXICO	Mexico
TECNOL ESTUDIOS SUPER ECATEPEC	Mexico
UNIV AUTONOMA AGUASCALIENTES	Mexico
UNIV AUTONOMA BAJA CALIFORNIA	Mexico
UNIV AUTONOMA CARMEN	Mexico
UNIV AUTONOMA CHIAPAS	Mexico
UNIV AUTONOMA CIUDAD JUAREZ	Mexico
UNIV AUTONOMA COAHUILA	Mexico
UNIV AUTONOMA ESTADO HIDALGO	Mexico
UNIV AUTONOMA ESTADO MEXICO	Mexico
UNIV AUTONOMA ESTADO MORELOS	Mexico
UNIV AUTONOMA GUADALAJARA	Mexico
UNIV AUTONOMA METROPOLITANA	Mexico
UNIV AUTONOMA NEUVO LEON	Mexico
UNIV AUTONOMA NUEVO LEON	Mexico
UNIV AUTONOMA QUERETARO	Mexico
UNIV AUTONOMA SAN LUIS POTOSI	Mexico
UNIV AUTONOMA SINALOA	Mexico
UNIV AUTONOMA TAMAULIPAS	Mexico
UNIV AUTONOMA YUCATAN	Mexico
UNIV AUTONOMA ZACATECAS	Mexico
UNIV COLIMA	Mexico
UNIV GUADALAJARA	Mexico
UNIV JUAREZ AUTONOMA TABASCO	Mexico
UNIV JUAREZ ESTADO DURANGO	Mexico
UNIV OCCIDENTE	Mexico
UNIV QUINTANA ROO	Mexico
UNIV SONORA	Mexico
UNIV CASABLANCA HASSAN 2	Morocco
UNIV MARRAKECH CADI AYYAD	Morocco
DELFT UNIV TECHNOL	Netherlands
EINDHOVEN UNIV TECHNOL	Netherlands
ERASMUS UNIV ROTTERDAM	Netherlands
LEIDEN UNIV	Netherlands
MAASTRICHT UNIV	Netherlands
RADBOUD UNIV NIJMEGEN	Netherlands
TILBURG UNIV	Netherlands
UNIV AMSTERDAM	Netherlands
UNIV GRONINGEN	Netherlands
UNIV TWENTE	Netherlands
UNIV UTRECHT	Netherlands
VU UNIV AMSTERDAM	Netherlands
WAGENINGEN UNIV & RES CTR	Netherlands
AGRESEARCH	New Zealand
AUCKLAND UNIV TECHNOL	New Zealand
BAY PLENTY POLYTECH	New Zealand
CAWTHRON INST	New Zealand
CHRISTCHURCH POLYTECH	New Zealand
EASTERN INST TECHNOL	New Zealand
ESR	New Zealand
GNS	New Zealand
INDUSTRIAL RESEARCH	New Zealand
LANDCARE RESEARCH	New Zealand
LINCOLN UNIV	New Zealand
MALAGHAN INST	New Zealand
MANUKAU INST TECHNOL	New Zealand
MASSEY UNIV	New Zealand
NELSON MARLBOROUGH INST TECHNOL	New Zealand
NIWA	New Zealand
NORTHTEC	New Zealand
OPEN POLYTECH NEW ZEALAND	New Zealand
OTAGO POLYTECH	New Zealand
PLANT & FOOD RESEARCH	New Zealand
SCION	New Zealand
SO INST TECHNOL	New Zealand
TE WANANGA O AOTEAROA	New Zealand
TE WHARE WANANGA O AWANUIARANGI	New Zealand
UNITEC NZ	New Zealand
UNIV AUCKLAND	New Zealand
UNIV CANTERBURY	New Zealand
UNIV OTAGO	New Zealand
UNIV WAIKATO	New Zealand
UNIVERSAL COLL LEARNING	New Zealand
VICTORIA UNIV WELLINGTON	New Zealand
WAIARIKI INST TECHNOL	New Zealand
WAIKATO INST TECHNOL	New Zealand
WELLINGTON INST TECHNOL	New Zealand
WESTERN INST TECHNOL TARANAKI	New Zealand
WHITIREIA COMMUNITY POLYTECH	New Zealand
REDEEMERS UNIV	Nigeria
UNIV IBADAN	Nigeria
NORWEGIAN UNIV SCI & TECHNOL	Norway
UNIV BERGEN	Norway
UNIV OSLO	Norway
UNIV TROMSO	Norway
SULTAN QABOOS UNIV	Oman
ABDUL WALI KHAN UNIV	Pakistan
ADAMJEE GOVT SCI COLL	Pakistan
AGA KHAN UNIV	Pakistan
AGR MECH RES INST	Pakistan
AGR UNIV PESHAWAR	Pakistan
ARID AGR UNIV	Pakistan
BAHAUDDIN ZAKARIYA UNIV	Pakistan
BAQAI MED UNIV	Pakistan
DOW UNIV HLTH SCI	Pakistan
FED URDU UNIV ARTS SCI & TECHNOL	Pakistan
GOMAL UNIV	Pakistan
GOMEL STATE UNIV	Pakistan
GOVT COLL UNIV FAISALABAD	Pakistan
GOVT COLL UNIV LAHORE	Pakistan
HAMDARD UNIV	Pakistan
HAZARA UNIV	Pakistan
IQRA UNIV	Pakistan
ISLAMIA DEGREE COLL	Pakistan
JINNAH DEGREE COLL WOMEN	Pakistan
KARAKORAM INT UNIV	Pakistan
KOHAT UNIV SCI & TECHNOL	Pakistan
LAHORE UNIV MANAGEMENT SCI	Pakistan
LASBELA UNIV AGR WATER & MARINE SCI	Pakistan
LIAQUT UNIV MED & HLTH SCI	Pakistan
MEHRAN UNIV ENGN & TECH	Pakistan
MOHAMMAD ALI JINNAH UNIV	Pakistan
NATL CNTR PHYS	Pakistan
NATL CTR EXCELLENCE MOL BIOL	Pakistan
NATL ENGN & SCI COMMISS	Pakistan
NATL INST AGR & BIOL	Pakistan
NATL TEXT UNIV	Pakistan
NATL UNIV SCI & TECHNOL	Pakistan
NED UNIV ENGN & TECHNOL	Pakistan
NITEC UNIV	Pakistan
NUCL INST AGR	Pakistan
NUCL INST AGR & BIOL	Pakistan
NUCL INST FOOD & AGR	Pakistan
NWFP AGR UNIV PESHAWAR	Pakistan
PAKISTAN AGR RES COUNCIL	Pakistan
PAKISTAN ATOM ENERGY COMMISS	Pakistan
PAKISTAN INST DEV ECON	Pakistan
PAKISTAN INST ENGN & APPL SCI	Pakistan
PAKISTAN INST MED SCI	Pakistan
PAKISTAN INST NUCL SCI & TECH	Pakistan
PAKISTAN MED RES COUNCIL	Pakistan
PAKISTAN MUSEUM NAT HIST	Pakistan
PAKISTAN SCI FDN	Pakistan
PCSIR LAB COMPLEX	Pakistan
PCSIR LABS COMPLEX	Pakistan
PCSIR LABS KARACHI	Pakistan
PUNJAB MED COLL	Pakistan
QUAID I AZAM UNIV	Pakistan
RAWALPINDI MEDICAL COLLEGE	Pakistan
SHAH ABDUL LATIF UNIV	Pakistan
SHIFA COLL MED	Pakistan
SINDH AGR UNIV	Pakistan
SIR SYED UNIV ENGN & TECHNOL	Pakistan
SUPARCO	Pakistan
SUSTAINABLE DEV POLICY INST	Pakistan
UNIV AGR FAISALABAD	Pakistan
UNIV AZAD JAMMU & KASHMIR	Pakistan
UNIV BALOCHISTAN	Pakistan
UNIV CENTR PUNJAB	Pakistan
UNIV ENGN & TECH	Pakistan
UNIV ENGN & TECH PRESHAWAR	Pakistan
UNIV ENGN & TECH TAXILA	Pakistan
UNIV GUJRAT	Pakistan
UNIV HLTH SCI	Pakistan
UNIV KARACHI	Pakistan
UNIV LAHORE	Pakistan
UNIV MALAKAND	Pakistan
UNIV PESHAWAR	Pakistan
UNIV PUNJAB	Pakistan
UNIV SARGODHA	Pakistan
UNIV SCI & TECHNOL BANNU	Pakistan
UNIV SINDH	Pakistan
UNIV VET & ANIM SCI	Pakistan
ZIAUDDIN UNIV	Pakistan
PONTIFICIA UNIV CATOL PERU	Peru
UNIV NACL MAYOR SAN MARCOS	Peru
ASIAN DEV BANK	Philippines
ATENEO MANILA UNIV	Philippines
CENT LUZON STATE UNIV	Philippines
DE LA SALLE UNIV	Philippines
FOOD & NUTR RES INST	Philippines
INT RICE RES INST	Philippines
MAKATI MED CTR	Philippines
MAPUA INST TECHNOL	Philippines
MINDANAO STATE UNIV	Philippines
NATL MUSEUM PHILIPPINES	Philippines
PHILIPPINE DEPT HLTH	Philippines
PHILIPPINE HEART CTR	Philippines
PHILIPPINE NUCL RES INST	Philippines
PHILIPPINE RICE RES INST	Philippines
RES INST TROP MED	Philippines
SE ASIAN FISHERIES DEV CTR	Philippines
SILLIMAN UNIV	Philippines
ST LUKES MED CTR	Philippines
UNIV PHILIPPINES DILIMAN	Philippines
UNIV PHILIPPINES LOS BANOS	Philippines
UNIV PHILIPPINES MANILA	Philippines
UNIV SAN CARLOS	Philippines
UNIV SANTO TOMAS	Philippines
VISAYAS STATE UNIV	Philippines
WHO WESTERN PACIFIC REG OFF	Philippines
WORLDFISH CTR	Philippines
ADAM MICKIEWICZ UNIV	Poland
AGH UNIV SCI & TECHNOL	Poland
AGR UNIV KRAKOW	Poland
AGR UNIV LUBLIN	Poland
AGR UNIV WROCLAW	Poland
CATHOLIC UNIV LUBLIN	Poland
CRACOW UNIV TECHNOL	Poland
GDANSK UNIV TECHNOL	Poland
GYDNIA MAR UNIV	Poland
JAGIELLONIAN UNIV	Poland
JAN DLUGOSZ UNIV	Poland
JAN KOCHANOWSKI UNIV	Poland
KAZIMIERZ WIELKI UNIV	Poland
KIELCE UNIV TECHNOL	Poland
KOSZALIN UNIV TECHNOL	Poland
LUBLIN UNIV TECHNOL	Poland
MARIA CURIE SKODOWSKA UNIV	Poland
MARITIME UNIV SZCZECIN	Poland
MED UNIV GDANSK	Poland
MED UNIV LODZ	Poland
MED UNIV SILESIA	Poland
MED UNIV WARSAW	Poland
NICOLAUS COPERNICUS UNIV	Poland
OPOLE UNIV TECHNOL	Poland
PEDAG UNIV CRACOW	Poland
POZNAN UNIV ECON	Poland
POZNAN UNIV LIFE SCI	Poland
POZNAN UNIV MED SCI	Poland
POZNAN UNIV TECHNOL	Poland
RZESZOW UNIV TECHNOL	Poland
SILESIAN UNIV TECHNOL	Poland
TECH UNIV CZESTOCHOWA	Poland
TECH UNIV LODZ	Poland
TECH UNIV RADOM	Poland
UNIV BIALYSTOK	Poland
UNIV BIELSKO BIALA	Poland
UNIV BYDGOSZCZ	Poland
UNIV FINANCE & MGMT WARSAW	Poland
UNIV GDANSK	Poland
UNIV LODZ	Poland
UNIV OPOLE	Poland
UNIV PODLASIE	Poland
UNIV RZESZOW	Poland
UNIV SILESIA	Poland
UNIV SZCZECIN	Poland
UNIV WARMIA & MAZURY	Poland
UNIV WARSAW	Poland
UNIV WROCLAW	Poland
UNIV ZIELONA GORA	Poland
W POMERANIAN UNIV TECHNOL	Poland
WARSAW AGR UNIV	Poland
WARSAW SCH ECON	Poland
WARSAW UNIV LIFE SCI	Poland
WARSAW UNIV OBSERV	Poland
WARSAW UNIV TECHNOL	Poland
WROCLAW UNIV ECON	Poland
WROCLAW UNIV ENVIRONM & LIFE SCI	Poland
WROCLAW UNIV TECHNOL	Poland
CATHOLIC UNIV PORTO	Portugal
NOVA UNIV LISBON	Portugal
PORTUGUESE CATHOLIC UNIV	Portugal
UNIV ALGARVE	Portugal
UNIV AVEIRO	Portugal
UNIV COIMBRA	Portugal
UNIV INST LISBON	Portugal
UNIV LISBON	Portugal
UNIV MINHO	Portugal
UNIV NOVA LISBOA	Portugal
UNIV PORTO	Portugal
UNIV TECN LISBON	Portugal
HAMAD MED CORP	Qatar
TEXAS A&M UNIV QATAR	Qatar
UNIV QATAR	Qatar
IVANE JAVAKHISHVILI TBILISI STATE UNIV	Republic of Georgia
1 DECEMBRIE 1918 UNIV ALBA IULIA	Romania
ALEXANDRU IOAN CUZA UNIV	Romania
DUNAREA DE JOS UNIV GALATI	Romania
GH ASACHI TECH UNIV	Romania
NATL INST RES & DEV TECH PHYS	Romania
POLITEHN UNIV TIMISOARA	Romania
POLYTECH UNIV BUCHAREST	Romania
ROMANIAN ACAD SCI	Romania
TECH UNIV CLUJ NAPOCA	Romania
TRANSILVANIA UNIV BRASOV	Romania
UNIV BABES BOLYAI	Romania
UNIV BUCHAREST	Romania
UNIV CRAIOVA	Romania
W UNIV TIMISOARA	Romania
FAR EAST FED UNIV	Moscow
IRKUTSK STATE UNIV	Moscow
KAZAN FED UNIV	Moscow
KAZAN STATE UNIV	Moscow
LOBACHEVSKY STATE UNIV NIZHNI NOVGOROD	Moscow
LOMONOSOV MOSCOW STATE UNIV	Moscow
MENDELEEV UNIV CHEM TECHNOL	Moscow
MORDOVIAN STATE UNIV	Moscow
MOSCOW ENG PHYS INST	Moscow
MOSCOW INST STEEL & ALLOYS	Moscow
MOSCOW PHYSICS & TECHNICS INST	Moscow
NOVOSIBIRSK STATE UNIV	Moscow
PEOPLES FRIENDSHIP UNIV RUSSIA	Moscow
RUSSIAN ACAD SCI	Moscow
RUSSIAN STATE MED UNIV	Moscow
SAMARA STATE UNIV	Moscow
SARATOV STATE UNIV	Moscow
SIBERIAN FED UNIV	Moscow
SO FED UNIV	Moscow
ST PETERSBURG STATE POLYTECH UNIV	Moscow
ST PETERSBURG STATE UNIV	Moscow
TOMSK POLYTECH UNIV	Moscow
TOMSK STATE UNIV	Moscow
URAL STATE UNIV	Moscow
VORONEZH STATE UNIV	Moscow
AL IMAM UNIV	Saudi Arabia
AL QASSEEM UNIV	Saudi Arabia
ALFAISAL UNIV	Saudi Arabia
KING ABDULAZIZ CITY SCI & TECHNOL	Saudi Arabia
KING ABDULAZIZ CITY SCITECHNOL	Saudi Arabia
KING ABDULAZIZ MED CITY	Saudi Arabia
KING ABDULAZIZ UNIV	Saudi Arabia
KING ABDULLAH UNIV SCI & TECHNOL	Saudi Arabia
KING FAHD UNIV PETR & MINERALS	Saudi Arabia
KING FAISAL UNIV	Saudi Arabia
KING KHALID UNIV	Saudi Arabia
KING SAUD BIN ABDULAZIZ UNIV HLTH SCI	Saudi Arabia
KING SAUD UNIV	Saudi Arabia
MINIST HLTH	Saudi Arabia
MINIST MINERAL RESOURCES	Saudi Arabia
NATIONAL GUARD HEALTH AFFAIRS	Saudi Arabia
QASSIM UNIV	Saudi Arabia
SAUDI ARAMCO	Saudi Arabia
UNIV BELGRADE	Serbia
AGCY SCI TECHNOL RES	Singapore
NANYANG TECHNOL UNIV	Singapore
NATL UNIV SINGAPORE	Singapore
SINGAPORE MANAGEMENT UNIV	Singapore
ACAD FINE ARTS & DESIGN BRATISLAVA	Slovakia
ALEXANDER DUBCEK UNIV TRENCIN	Slovakia
CATHOLIC UNIV RUZOMBEROK	Slovakia
COMENIUS UNIV BRATISLAVA	Slovakia
CONSTANTINE PHILOSOPHER UNIV NITRA	Slovakia
FOOD RES INST	Slovakia
MATEJ BEL UNIV	Slovakia
NATL FOREST CTR	Slovakia
SLOVAK ACAD SCI	Slovakia
SLOVAK AGR RES CTR	Slovakia
SLOVAK MED UNIV BRATISLAVA	Slovakia
SLOVAK NATL LIB MARTIN	Slovakia
SLOVAK UNIV AGR NITRA	Slovakia
SLOVAK UNIV TECHNOL BRATISLAVA	Slovakia
TECH UNIV KOSICE	Slovakia
TECH UNIV ZVOLEN	Slovakia
UNIV ECON BRATISLAVA	Slovakia
UNIV LIB BRATISLAVA	Slovakia
UNIV PAVOL JOZEF SAFARIK KOSICE	Slovakia
UNIV PRESOVE	Slovakia
UNIV SELYE JANOS KOMARNO	Slovakia
UNIV SS CYRIL & METHODIUS TRNAVA	Slovakia
UNIV TRNAVA	Slovakia
UNIV VETERINARY MED KOSICE	Slovakia
UNIV ZILINA	Slovakia
AGR INST SLOVENIA	Slovenia
INST MET & TECHNOL	Slovenia
INST ONCOL	Slovenia
JOZEF STEFAN INST	Slovenia
NATL INST BIOL	Slovenia
NATL INST CHEM	Slovenia
UNIV LJUBLJANA	Slovenia
UNIV MARIBOR	Slovenia
UNIV NOVA GORICA	Slovenia
UNIV PRIMORSKA	Slovenia
CAPE PENINSULA UNIV TECHNOL	South Africa
CENTRAL UNIV TECHNOL	South Africa
CSIR - SOUTH AFRICA	South Africa
DURBAN UNIV TECHNOL	South Africa
MANGOSUTHU UNIV TECHNOL	South Africa
NATL RES FDN	South Africa
NELSON MANDELA METROPOL UNIV	South Africa
NORTH WEST UNIV	South Africa
RHODES UNIV	South Africa
STELLENBOSCH UNIV	South Africa
TSHWANE UNIV TECHNOL	South Africa
UNIV CAPE TOWN	South Africa
UNIV FORT HARE	South Africa
UNIV FREE STATE	South Africa
UNIV JOHANNESBURG	South Africa
UNIV KWAZULU NATAL	South Africa
UNIV LIMPOPO	South Africa
UNIV PRETORIA	South Africa
UNIV SOUTH AFRICA	South Africa
UNIV VENDA	South Africa
UNIV WEST CAPE	South Africa
UNIV WITWATERSRAND	South Africa
UNIV ZULULAND	South Africa
VAAL UNIV TECHNOL	South Africa
VISTA UNIV	South Africa
WALTER SISULU UNIV TECHNOL & SCI	South Africa
AJOU UNIV	South Korea
ANDONG NATL UNIV	South Korea
CATHOLIC UNIV KOREA	South Korea
CHANGWON NATL UNIV	South Korea
CHONBUK NATL UNIV	South Korea
CHONNAM NATL UNIV	South Korea
CHOSUN UNIV	South Korea
CHUNG ANG UNIV	South Korea
CHUNGBUK NATL UNIV	South Korea
CHUNGNAM NATL UNIV	South Korea
DANKOOK UNIV	South Korea
DONG A UNIV	South Korea
DONGGUK UNIV	South Korea
ELECT & TELECOMMUN RES INST	South Korea
EWHA WOMANS UNIV	South Korea
GWANGJU INST SCI & TECH	South Korea
GYEONGSANG NATL UNIV	South Korea
HALLYM UNIV	South Korea
HANYANG UNIV	South Korea
HONGIK UNIV	South Korea
INHA UNIV	South Korea
INJE UNIV	South Korea
JEJU NATL UNIV	South Korea
KAIST	South Korea
KANGWON NATL UNIV	South Korea
KEIMYUNG UNIV	South Korea
KONGJU NATL UNIV	South Korea
KONKUK UNIV	South Korea
KOOKMIN UNIV	South Korea
KOREA ATOM ENERGY RES INST	South Korea
KOREA BASIC SCI INST	South Korea
KOREA INST ADV STUDY	South Korea
KOREA INST MACHINERY & MAT	South Korea
KOREA INST SCI & TECH	South Korea
KOREA OCEAN RES & DEV INST	South Korea
KOREA RES INST BIOSCI & BIOTECH	South Korea
KOREA RES INST CHEM TECH	South Korea
KOREA RES INST STAND & SCI	South Korea
KOREA UNIV	South Korea
KWANGWOON UNIV	South Korea
KYUNG HEE UNIV	South Korea
KYUNGPOOK NATL UNIV	South Korea
MYONGJI UNIV	South Korea
NATL CANC CTR - KOREA	South Korea
POCHON CHA UNIV	South Korea
POSTECH	South Korea
PUKYONG NATL UNIV	South Korea
PUSAN NATL UNIV	South Korea
SEJONG UNIV	South Korea
SEOUL NATL UNIV	South Korea
SOGANG UNIV	South Korea
SOOKMYUNG WOMENS UNIV	South Korea
SOONCHUNHYANG UNIV	South Korea
SOONGSIL UNIV	South Korea
SUNCHON NATL UNIV	South Korea
SUNGKYUNKWAN UNIV	South Korea
ULSAN NATL UNIV SCI & TECHNOL	South Korea
UNIV SEOUL	South Korea
UNIV ULSAN	South Korea
WONKWANG UNIV	South Korea
YEUNGNAM UNIV	South Korea
YONSEI UNIV	South Korea
CSIC	Spain
ESADE	Spain
ESIC BUSINESS & MARKETING SCH	Spain
UNIV AUTONOMA BARCELONA	Spain
UNIV AUTONOMA MADRID	Spain
UNIV BARCELONA	Spain
UNIV BASQUE COUNTRY	Spain
UNIV CARLOS III MADRID	Spain
UNIV COMPLUTENSE MADRID	Spain
UNIV GRANADA	Spain
UNIV MURCIA	Spain
UNIV NAVARRA	Spain
UNIV OVIEDO	Spain
UNIV POLYTECH CATALUNYA	Spain
UNIV POLYTECH MADRID	Spain
UNIV POLYTECH VALENCIA	Spain
UNIV POMPEU FABRA	Spain
UNIV SALAMANCA	Spain
UNIV SANTIAGO DE COMPOSTELA	Spain
UNIV SEVILLA	Spain
UNIV VALENCIA	Spain
UNIV VIGO	Spain
UNIV ZARAGOZA	Spain
UNIV COLOMBO	Sri Lanka
UNIV PERADENIYA	Sri Lanka
CHALMERS UNIV TECHNOL	Sweden
DALARNA UNIV	Sweden
FRAUNHOFER RES CTR IND MATH	Sweden
HALMSTAD UNIV	Sweden
JONKOPING UNIV	Sweden
KARLSTAD UNIV	Sweden
KAROLINSKA INST	Sweden
KRISTIANSTAD UNIV	Sweden
LINKOPING UNIV	Sweden
LINNAEUS UNIV	Sweden
LULEA UNIV TECH	Sweden
LUND UNIV	Sweden
MALARDALEN UNIV	Sweden
MALMO UNIV	Sweden
MID-SWEDEN UNIV	Sweden
OREBRO UNIV	Sweden
ROYAL INST TECHNOL	Sweden
SODERTORN UNIV COLL	Sweden
STOCKHOLM SCH ECON	Sweden
STOCKHOLM UNIV	Sweden
SWEDISH UNIV AGR SCI	Sweden
UMEA UNIV	Sweden
UNIV GOTHENBURG	Sweden
UNIV KALMAR	Sweden
UNIV SKOVDE	Sweden
UPPSALA UNIV	Sweden
VAXJO UNIV	Sweden
BUS SCH LAUSANNE	Switzerland
CERN	Switzerland
EURO SOC MED ONCOL	Switzerland
SWISS FED INST TECHNOL LAUSANNE	Switzerland
SWISS FED INST TECHNOL ZURICH	Switzerland
UNIV BASEL	Switzerland
UNIV BERN	Switzerland
UNIV FRIBOURG	Switzerland
UNIV GENEVA	Switzerland
UNIV LAUSANNE	Switzerland
UNIV LUCERNE	Switzerland
UNIV LUGANO	Switzerland
UNIV NEUCHATEL	Switzerland
UNIV ST GALLEN	Switzerland
UNIV ZURICH	Switzerland
WORLD HLTH ORG	Switzerland
ZURICH UNIV APPL SCI	Switzerland
ARMED FORCES RES INST MED SCI	Thailand
ASIAN INST TECHNOL	Thailand
BURAPHA UNIV	Thailand
CHEST DIS RES INST	Thailand
CHIANG MAI UNIV	Thailand
CHULABHORN RES INST	Thailand
CHULALONGKORN UNIV	Thailand
DEPT MINERAL RESOURCES	Thailand
KASETSART UNIV	Thailand
KHON KAEN UNIV	Thailand
KING MONGKUTS UNIV TECHNOL (NOT IDENTIFIED)	Thailand
KING MONGKUTS UNIV TECHNOL LADKRABANG	Thailand
KING MONGKUTS UNIV TECHNOL N BANGKOK	Thailand
KING MONGKUTS UNIV TECHNOL THONBURI	Thailand
MAE FAH LUANG UNIV	Thailand
MAEJO UNIV	Thailand
MAHANAKORN UNIV TECHNOL	Thailand
MAHASARAKHAM UNIV	Thailand
MAHIDOL UNIV	Thailand
MINIST AGR & COOPERAT	Thailand
MINIST PUBL HLTH	Thailand
NARESUAN UNIV	Thailand
NATL CANC INST	Thailand
NATL SCI & TECHNOL DEV AGCY	Thailand
PHRAMONGKUTKLAO COLL MED	Thailand
PRINCE SONGKLA UNIV	Thailand
RAJAMANGALA UNIV TECHNOL LANNA	Thailand
RAMKHAMHAENG UNIV	Thailand
RANGSIT UNIV	Thailand
ROYAL FOREST DEPT	Thailand
SAKON NAKHON RAJABHAT UNIV	Thailand
SILPAKORN UNIV	Thailand
SRINAKHARINWIROT UNIV	Thailand
SURANAREE UNIV TECHNOL	Thailand
THAI RED CROSS SOC	Thailand
THAILAND INST SCI & TECHNOL RES	Thailand
THAMMASAT UNIV	Thailand
UBON RATCHATHANI UNIV	Thailand
UDON THANI RAJABHAT UNIV	Thailand
WALAILAK UNIV	Thailand
UNIV MONASTIR	Tunisia
UNIV SFAX	Tunisia
29 MAYIS HASTANESI	Turkey
ABANT IZZET BAYSAL UNIV	Turkey
ACIBADEM HASTANELERI	Turkey
ACIBADEM UNIV	Turkey
ADALET BAKANLIGI	Turkey
ADANA NUMUNE EAH	Turkey
ADIYAMAN UNIV	Turkey
ADNAN MENDERES UNIV	Turkey
AFYON KOCATEPE UNIV	Turkey
AGRI DAGI IBRAHIM CECEN UNIV	Turkey
AHI EVRAN UNIV	Turkey
AKDENIZ UNIV	Turkey
AKSARAY UNIV	Turkey
AMASYA UNIV	Turkey
AMERIKAN HASTANESI	Turkey
ANADOLU SAGLIK MERKEZI	Turkey
ANADOLU UNIV	Turkey
ANKARA ATATURK EAH	Turkey
ANKARA DISKAPI YILDIRIM BEYAZIT EAH	Turkey
ANKARA DR A YURTARSLAN ONKOLOJI EAH	Turkey
ANKARA EAH	Turkey
ANKARA ETLIK IHTISAS EAH	Turkey
ANKARA KECIOREN EAH	Turkey
ANKARA NUMUNE EAH	Turkey
ANKARA TURKIYE YUKSEK IHTISAS EAH	Turkey
ANKARA ULUCANLAR GOZ EAH	Turkey
ANKARA UNIV	Turkey
ANTALYA EAH	Turkey
ARCELIK	Turkey
ARDAHAN UNIV	Turkey
ARTVIN CORUH UNIV	Turkey
ASELSAN	Turkey
ASKERI HASTANELER	Turkey
ATATURK UNIV	Turkey
ATILIM UNIV	Turkey
BAHCESEHIR UNIV	Turkey
BALIKESIR UNIV	Turkey
BARTIN UNIV	Turkey
BASBAKANLIK	Turkey
BASKENT UNIV	Turkey
BATMAN UNIV	Turkey
BAYBURT UNIV	Turkey
BAYINDIR HASTANESI	Turkey
BAYINDIRLIK VE ISKAN BAKANLIGI	Turkey
BELEDIYELER	Turkey
BEYKENT UNIV	Turkey
BEZMIALEM UNIV	Turkey
BILECIK UNIV	Turkey
BILKENT UNIV	Turkey
BINGOL UNIV	Turkey
BITLIS EREN UNIV	Turkey
BOGAZICI UNIV	Turkey
BOZOK UNIV	Turkey
BURSA YUKSEK IHTISAS EAH	Turkey
CAG UNIV	Turkey
CALISMA VE SOSYAL GUVENLIK BAKANLIGI	Turkey
CANAKKALE ONSEKIZ MART UNIV	Turkey
CANKAYA UNIV	Turkey
CANKIRI KARATEKIN UNIV	Turkey
CELAL BAYAR UNIV	Turkey
CEVRE VE ORMAN BAKANLIGI	Turkey
CUKUROVA UNIV	Turkey
CUMHURBASKANLIGI	Turkey
CUMHURIYET UNIV	Turkey
DENIZ HARP OKULU KOMUTANLIGI	Turkey
DENIZ KUVVETLERI KOMUTANLIGI	Turkey
DERNEK VE VAKIFLAR	Turkey
DEVLET HASTANELERI	Turkey
DEVLET PLANLAMA TESKILATI	Turkey
DICLE UNIV	Turkey
DIGER DEVLET KURULUSLARI	Turkey
DIGER FIRMALAR	Turkey
DIGER OZEL HASTANELER	Turkey
DIYARBAKIR EAH	Turkey
DOGU AKDENIZ UNIV	Turkey
DOGUS UNIV	Turkey
DOKUZ EYLUL UNIV	Turkey
DSI	Turkey
DUMLUPINAR UNIV	Turkey
DUNYA GOZ HASTANESI	Turkey
DUZCE UNIV	Turkey
ECZACIBASI AS	Turkey
EGE UNIV	Turkey
ELAZIG EAH	Turkey
ENERJI VE TABII KAYNAKLAR BAKANLIGI	Turkey
ERCIYES UNIV	Turkey
EREGLI DEMIR CELIK AS	Turkey
ERZINCAN UNIV	Turkey
ERZURUM EAH	Turkey
ERZURUM NUMUNE EAH	Turkey
ESKISEHIR OSMANGAZI UNIV	Turkey
ETI HOLDING	Turkey
FATIH UNIV	Turkey
FIRAT UNIV	Turkey
FLORANCE NIGHTINGALE HASTANELERI	Turkey
FORD OTOSAN	Turkey
GALATASARAY UNIV	Turkey
GATA	Turkey
GAZI UNIV	Turkey
GAZIANTEP UNIV	Turkey
GAZIOSMANPASA UNIV	Turkey
GEBZE YUKSEK TEKNOLOJI ENSTITUSU	Turkey
GENEL KURMAY BASKANLIGI	Turkey
GIRESUN UNIV	Turkey
GIRNE AMERIKAN UNIV	Turkey
GUMUSHANE UNIV	Turkey
GUVEN HASTANESI	Turkey
HACETTEPE UNIV	Turkey
HAKKARI UNIV	Turkey
HALIC UNIV	Turkey
HARITA GENEL KOMUTANLIGI	Turkey
HARP AKADEMILERI KOMUTANLIGI	Turkey
HARRAN UNIV	Turkey
HAVA HARP OKULU KOMUTANLIGI	Turkey
HAVA KUVVETLERI KOMUTANLIGI	Turkey
HITIT UNIV	Turkey
ICISLERI BAKANLIGI	Turkey
IGDIR UNIV	Turkey
INONU UNIV	Turkey
ISIK UNIV	Turkey
ISTANBUL AREL UNIV	Turkey
ISTANBUL AYDIN UNIV	Turkey
ISTANBUL BAGCILAR EAH	Turkey
ISTANBUL BAKIRKOY DR SADI KONUK EAH	Turkey
ISTANBUL BILGI UNIV	Turkey
ISTANBUL BILIM UNIV	Turkey
ISTANBUL EAH	Turkey
ISTANBUL FATIH SULTAN MEHMET EAH	Turkey
ISTANBUL GOZTEPE EAH	Turkey
ISTANBUL HASEKI EAH	Turkey
ISTANBUL HAYDARPASA NUMUNE EAH	Turkey
ISTANBUL KARTAL DR LUTFI KIRDAR EAH	Turkey
ISTANBUL KULTUR UNIV	Turkey
ISTANBUL OKMEYDANI EAH	Turkey
ISTANBUL RETINA ENSTITUSU	Turkey
ISTANBUL SISLI ETFAL EAH	Turkey
ISTANBUL TAKSIM EAH	Turkey
ISTANBUL TEKNIK UNIV	Turkey
ISTANBUL TICARET UNIV	Turkey
ISTANBUL UMRANIYE EAH	Turkey
ISTANBUL UNIV	Turkey
IZMIR ATATURK EAH	Turkey
IZMIR BOZYAKA EAH	Turkey
IZMIR EAH	Turkey
IZMIR EKONOMI UNIV	Turkey
IZMIR TEPECIK EAH	Turkey
IZMIR YUKSEK TEKNOLOJI ENSTITUSU	Turkey
JANDARMA GENEL KOMUTANLIGI	Turkey
KADIR HAS UNIV	Turkey
KAFKAS UNIV	Turkey
KAHRAMANMARAS SUTCU IMAM UNIV	Turkey
KARA HARP OKULU KOMUTANLIGI	Turkey
KARA KUVVETLERI KOMUTANLIGI	Turkey
KARABUK UNIV	Turkey
KARADENIZ TEKNIK UNIV	Turkey
KARAMANOGLU MEHMETBEY UNIV	Turkey
KARATEKIN UNIV	Turkey
KASTAMONU UNIV	Turkey
KAYSERI EAH	Turkey
KILIS 7 ARALIK UNIV	Turkey
KIRIKKALE UNIV	Turkey
KIRIKKALE YUKSEK IHTISAS EAH	Turkey
KIRKLARELI UNIV	Turkey
KIRSEHIR AHI EVRAN UNIV	Turkey
KIZILAY	Turkey
KOC UNIV	Turkey
KOCAELI EAH	Turkey
KOCAELI UNIV	Turkey
KONYA MERAM EAH	Turkey
KUDRET GOZ HASTANESI	Turkey
KULTUR VE TURIZM BAKANLIGI	Turkey
LEFKE AVRUPA UNIV	Turkey
LOSEV	Turkey
MALTEPE UNIV	Turkey
MARMARA UNIV	Turkey
MEDICALPARK HASTANELERI	Turkey
MEDIKANA HASTANELERI	Turkey
MEHMET AKIF ERSOY UNIV	Turkey
MELIK SAH UNIV	Turkey
MEMORIAL HASTANESI	Turkey
MERKEZ BANKASI	Turkey
MERSIN UNIV	Turkey
MESA HASTANELERI	Turkey
MILLI EGITIM BAKANLIGI	Turkey
MIMAR SINAN GUZEL SANATLAR UNIV	Turkey
MTA	Turkey
MUGLA UNIV	Turkey
MUS ALPARSLAN UNIV	Turkey
MUSTAFA KEMAL UNIV	Turkey
NAMIK KEMAL UNIV	Turkey
NEVSEHIR UNIV	Turkey
NIGDE UNIV	Turkey
OKAN UNIV	Turkey
ONDOKUZ MAYIS UNIV	Turkey
ORDU UNIV	Turkey
ORTA DOGU TEKNIK UNIV	Turkey
OSMANIYE KORKUT ATA UNIV	Turkey
OZYEGIN UNIV	Turkey
PAK MAYA	Turkey
PAMUKKALE UNIV	Turkey
PETKIM	Turkey
PIRI REIS UNIV	Turkey
RIZE EAH	Turkey
RIZE UNIV	Turkey
SABANCI UNIV	Turkey
SAGLIK BAKANLIGI	Turkey
SAKARYA EAH	Turkey
SAKARYA UNIV	Turkey
SAMSUN MEHMET AYDIN EAH	Turkey
SANAYI VE TICARET BAKANLIGI	Turkey
SANI KONUKOGLU HASTANESI	Turkey
SANLIURFA EAH	Turkey
SAVUNMA BAKANLIGI	Turkey
SELCUK UNIV	Turkey
SIFA HASTANESI	Turkey
SIIRT UNIV	Turkey
SINOP UNIV	Turkey
SIRNAK UNIV	Turkey
SISE VE CAM FABRIKALARI AS	Turkey
SULEYMAN DEMIREL UNIV	Turkey
TAEK	Turkey
TARIM VE KOY ISLERI BAKANLIGI	Turkey
TBMM	Turkey
TOBB EKONOMI VE TEKNOLOJI UNIV	Turkey
TPAO	Turkey
TRABZON NUMUNE EAH	Turkey
TRAKYA UNIV	Turkey
TSE	Turkey
TUBA	Turkey
TUBITAK	Turkey
TUNCELI UNIV	Turkey
TURKIYE KARDIYOLOJI DERNEGI	Turkey
TUSAS	Turkey
UFUK UNIV	Turkey
ULASTIRMA BAKANLIGI	Turkey
ULUDAG UNIV	Turkey
ULUSLARARASI KIBRIS UNIV	Turkey
UNIVERSAL HOSPITALS GROUP	Turkey
USAK UNIV	Turkey
VAN EAH	Turkey
VAN YUKSEK IHTISAS EAH	Turkey
YAKIN DOGU UNIV	Turkey
YALOVA UNIV	Turkey
YASAR UNIV	Turkey
YEDITEPE UNIV	Turkey
YILDIZ TEKNIK UNIV	Turkey
YUZUNCU YIL UNIV	Turkey
ZIRVE UNIV	Turkey
ZONGULDAK KARAELMAS UNIV	Turkey
BIRKBECK UNIV LONDON	Uganda
DURHAM UNIV	UK
GOLDSMITHS UNIV LONDON	UK
LANCASTER UNIV	UK
LOUGHBOROUGH UNIV	UK
QUEEN MARY UNIV LONDON	UK
ROYAL HOLLOWAY UNIV LONDON	UK
UNIV BATH	UK
UNIV E ANGLIA	UK
UNIV ESSEX	UK
UNIV EXETER	UK
UNIV LEICESTER	UK
UNIV LONDON INST EDUC	UK
UNIV LONDON SOAS	UK
UNIV READING	UK
UNIV ST ANDREWS	UK
UNIV SURREY	UK
UNIV SUSSEX	UK
UNIV YORK	UK
ABERYSTWYTH UNIV	UK
ANGLIA RUSKIN UNIV	UK
ARTS UNIV COLL BOURNEMOUTH	UK
ASTON UNIV	UK
BANGOR UNIV	UK
BATH SPA UNIV	UK
BBSRC BABRAHAM INST	UK
BBSRC JOHN INNES CTR	UK
BBSRC ROSLIN INST	UK
BIRKBECK UNIV LONDON	UK
BIRMINGHAM CITY UNIV	UK
BOURNEMOUTH UNIV	UK
BRUNEL UNIV	UK
BUCKS NEW UNIV	UK
CANTERBURY CHRIST CHURCH UNIV	UK
CARDIFF METROPOLITAN UNIV	UK
CARDIFF UNIV	UK
CENT SCH SPEECH & DRAMA	UK
CITY UNIV LONDON	UK
COVENTRY UNIV	UK
CRANFIELD UNIV	UK
DE MONTFORT UNIV	UK
DURHAM UNIV	UK
EDGE HILL UNIV	UK
EDINBURGH COLL ART	UK
GLASGOW CALEDONIAN UNIV	UK
GLASGOW SCH ART	UK
GLYNDWR UNIV	UK
GOLDSMITHS UNIV LONDON	UK
HARPER ADAMS UNIV COLL	UK
HERIOT WATT UNIV	UK
IMPERIAL COLL LONDON	UK
INST CANC RES	UK
INST SYST LEVEL INTEGRAT	UK
KEELE UNIV	UK
KINGS COLL LONDON	UK
KINGSTON UNIV	UK
LANCASTER UNIV	UK
LEEDS METROPOLITAN UNIV	UK
LIVERPOOL HOPE UNIV	UK
LIVERPOOL JOHN MOORES UNIV	UK
LONDON BUSINESS SCH	UK
LONDON METROPOLITAN UNIV	UK
LONDON S BANK UNIV	UK
LONDON SCH ECON & POLIT SCI	UK
LONDON SCH HYG & TROP MED	UK
LOUGHBOROUGH UNIV	UK
MANCHESTER METROPOLITAN UNIV	UK
METEOROLOGICAL OFF	UK
MIDDLESEX UNIV	UK
MRC LAB MOL BIOL	UK
MRC NATL INST MED RES	UK
NAPIER UNIV	UK
NERC BRITISH ANTARCTIC SURVEY	UK
NERC CTR ECOL & HYDROL	UK
NEWCASTLE UNIV	UK
NEWMAN UNIV COLL	UK
NORTHUMBRIA UNIV	UK
NOTTINGHAM TRENT UNIV	UK
OPEN UNIV	UK
OXFORD BROOKES UNIV	UK
QUEEN MARGARET UNIV	UK
QUEEN MARY UNIV LONDON	UK
QUEENS UNIV BELFAST	UK
ROBERT GORDON UNIV	UK
ROEHAMPTON UNIV	UK
ROYAL AGR COLL	UK
ROYAL COLL ART	UK
ROYAL COLL MUS	UK
ROYAL HOLLOWAY UNIV LONDON	UK
ROYAL NO COLL MUS	UK
SCOTTISH UNIV RES & REACTOR CTR	UK
SHEFFIELD HALLAM UNIV	UK
SOUTHAMPTON SOLENT UNIV	UK
ST GEORGES UNIV LONDON	UK
STAFFORDSHIRE UNIV	UK
STFC DARESBURY LAB	UK
STFC RUTHERFORD APPLETON LAB	UK
SWANSEA METROPOLITAN UNIV	UK
SWANSEA UNIV	UK
UHI MILLENNIUM INST	UK
UK ATOM ENERGY AUTHOR	UK
UNIV ABERDEEN	UK
UNIV ABERTAY DUNDEE	UK
UNIV ARTS LONDON	UK
UNIV BATH	UK
UNIV BEDFORDSHIRE	UK
UNIV BIRMINGHAM	UK
UNIV BOLTON	UK
UNIV BRADFORD	UK
UNIV BRIGHTON	UK
UNIV BRISTOL	UK
UNIV BUCKINGHAM	UK
UNIV CAMBRIDGE	UK
UNIV CENT LANCASHIRE	UK
UNIV CHESTER	UK
UNIV CHICHESTER	UK
UNIV COLL BIRMINGHAM	UK
UNIV COLL CREATIVE ARTS	UK
UNIV COLL FALMOUTH	UK
UNIV COLL LONDON	UK
UNIV CUMBRIA	UK
UNIV DERBY	UK
UNIV DUNDEE	UK
UNIV E ANGLIA	UK
UNIV E LONDON	UK
UNIV EDINBURGH	UK
UNIV ESSEX	UK
UNIV EXETER	UK
UNIV GLAMORGAN	UK
UNIV GLASGOW	UK
UNIV GLOUCESTERSHIRE	UK
UNIV GREENWICH	UK
UNIV HERTFORDSHIRE	UK
UNIV HUDDERSFIELD	UK
UNIV HULL	UK
UNIV KENT	UK
UNIV LEEDS	UK
UNIV LEICESTER	UK
UNIV LINCOLN	UK
UNIV LIVERPOOL	UK
UNIV LONDON	UK
UNIV LONDON COURTAULD INST ART	UK
UNIV LONDON HEYTHROP COLL	UK
UNIV LONDON INST EDUC	UK
UNIV LONDON ROYAL ACAD MUS	UK
UNIV LONDON ROYAL VET COLL	UK
UNIV LONDON SCH PHARM	UK
UNIV LONDON SOAS	UK
UNIV MANCHESTER	UK
UNIV NORTHAMPTON	UK
UNIV NOTTINGHAM	UK
UNIV OXFORD	UK
UNIV PLYMOUTH	UK
UNIV PORTSMOUTH	UK
UNIV READING	UK
UNIV SALFORD	UK
UNIV SHEFFIELD	UK
UNIV SOUTHAMPTON	UK
UNIV ST ANDREWS	UK
UNIV STIRLING	UK
UNIV STRATHCLYDE	UK
UNIV SUNDERLAND	UK
UNIV SURREY	UK
UNIV SUSSEX	UK
UNIV TEESSIDE	UK
UNIV ULSTER	UK
UNIV W ENGLAND	UK
UNIV W LONDON	UK
UNIV W SCOTLAND	UK
UNIV WALES NEWPORT	UK
UNIV WALES TRINITY ST DAVID	UK
UNIV WARWICK	UK
UNIV WESTMINSTER	UK
UNIV WINCHESTER	UK
UNIV WOLVERHAMPTON	UK
UNIV WORCESTER	UK
UNIV YORK	UK
WELLCOME TRUST SANGER INST	UK
WRITTLE COLL	UK
YORK ST JOHN UNIV	UK
KREMENCHUK MYKHAILO OSTROHRADSKYI NATL U	Ukraine
NATL ACAD SCI UKRAINE	Ukraine
NATL TECH UNIV KHARKIV POLYTECH INST	Ukraine
NATL TECH UNIV UKRAINE KIEV POLYTEC INST	Ukraine
NATL UNIV OSTROH ACAD	Ukraine
TARAS SHEVCHENKO NATL UNIV KIEV	Ukraine
V.N. KARAZIN KHARKIV NATL UNIV	Ukraine
VADYM HETMAN KIEV NATL ECON UNIV	Ukraine
ABU DHABI UNIV	United Arab Emirates
AMER UNIV SHARJAH	United Arab Emirates
EMIRATES AVIATION COLL	United Arab Emirates
HIGHER COLL TECHNOL	United Arab Emirates
KHALIFA UNIV SCI TECHNOL & RES	United Arab Emirates
MASDAR INST SCI & TECHNOL	United Arab Emirates
PETROLEUM INST	United Arab Emirates
UNITED ARAB EMIRATES UNIV	United Arab Emirates
UNIV REPUBLIC	Uruguay
UNIV CENTRAL VENEZUELA	Venezuela
UNIV LOS ANDES VENEZUELA	Venezuela
UNIV SIMON BOLIVAR	Venezuela
CAN THO UNIV	Vietnam
HANOI MED UNIV	Vietnam
HANOI NATL UNIV EDUC	Vietnam
HANOI UNIV AGR	Vietnam
HANOI UNIV OF SCI & TECHNOL	Vietnam
HANOI UNIV PHARM	Vietnam
HOCHIMINH CITY UNIV MED & PHARM	Vietnam
HUE UNIV	Vietnam
INST MATHEMATICS VIETNAM	Vietnam
NATL ECON UNIV	Vietnam
UNIV DANANG	Vietnam
UNIV HANOI	Vietnam
VIETNAM NATL UNIV	Vietnam
VIETNAM NATL UNIV HANOI	Vietnam
VIETNAM NATL UNIV HOCHIMINH CITY	Vietnam
