UNIV TORONTO	UNIV TORONTO
514 DONNELLY CTR CELLULAR & BIOMOL RES	UNIV TORONTO
BANTING & BEST DEPT MED RES	UNIV TORONTO
BANTING & BEST INST MED RES	UNIV TORONTO
CTR CELLULAR & BIOMOL RES	UNIV TORONTO
CTR CELLULAR & MOLEC BIOL	UNIV TORONTO
DALLA LANA SCH PUBL HLTH	UNIV TORONTO
DONNELLEY CTR	UNIV TORONTO
DONNELLEY CTR CELLULAR & BIOMOL RES	UNIV TORONTO
DONNELLY CTR CELLULAR & BIOMOL RES	UNIV TORONTO
DONNELY CCBR	UNIV TORONTO
TERENCE DONNELLY CTR CELLULAR & BIOMOL RES	UNIV TORONTO
TERRENCE DONNELLY CTR CELLULAR & BIOMOL RES	UNIV TORONTO
Algoma University	Ontario
BLOORVIEW KIDS REHAB	Ontario
BLOORVIEW RES INST	Ontario
BLOORVIEW RES INST & BLOORVIEW KIDS REHAB	Ontario
BLOORVIEWS KIDS REHAB	Ontario
BRIDGEPOINT HLTH	Ontario
BROCK UNIV	Ontario
Brock University	Ontario
CAMH	UNIV TORONTO
CAMPBELL FAMILY CANC RES INST	Ontario
CAMPBELL FAMILY INST BREAST CANC RES	Ontario
CAMPBELL FAMILY INST CANC RES	Ontario
CAMPUS VIRCHOW KLINIKUM	Ontario
CANC CARE ONTARIO	Ontario
CARLETON UNIV	Ontario
Carleton University	Ontario
COLL PHYSIOTHERAPISTS ONTARIO	Ontario
CREDIT VALLEY HOSP	Ontario
CTR ADDICT & MENTAL HLTH	Ontario
DURHAM REG CANC CTR	Ontario
DURHAM REG HLTH DEPT	Ontario
ETOBICOKE GEN HOSP	Ontario
GTA REHAB NETWORK	Ontario
GTA REHAB NETWORK TORONTO ABI NETWORK	Ontario
HAMILTON HLTH SCI CORP	Ontario
HAMILTON REG LAB MED PROGRAM	Ontario
HOLLAND BLOORVIEW KIDS REHABIL HOSP	Ontario
JOSEPH BRANT MEM HOSP	Ontario
JOSEPHS HLTH CTR	Ontario
LAKEHEAD UNIV	Ontario
Lakehead University	Ontario
LAKERIDGE HLTH CORP	Ontario
LAKERIDGE HLTH CTR	Ontario
LAKERIDGE HLTH NETWORK	Ontario
LAURENTIAN UNIV	Ontario
Laurentian University	Ontario
MAPLE LEAF MED CLIN	Ontario
MARKHAM STOUFFVILLE HOSP	Ontario
MARS CTR	UNIV TORONTO
MCGILL UNIV	Canada
MCLAUGHLIN CTR MOL MED	Ontario
MCLAUGHLIN RES INST	Ontario
MCMASTER UNIV	Ontario
McMaster University	Ontario
MED CTR COBURG	Ontario
MT SINAI HOSP	Ontario
N YORK GEN HOSP	Ontario
N&E GREATER TORONTO AREA ONTARIO REG STROKE CTR	Ontario
NIAGARA HLTH SYST	Ontario
NIAGARA REG PUBL HLTH	Ontario
NIPISSING UNIV	Ontario
Nipissing University	Ontario
OCAD University	Ontario
ODETTE CANC CTR	Ontario
ONTARIO AGCY HLTH PROTECT & PROMOT	Ontario
ONTARIO FAMILIAL BREAST CANC REGISTRY	Ontario
ONTARIO FORENS PATHOL SERV	Ontario
ONTARIO GENOM INST	Ontario
ONTARIO MINIST ENVIRONM	Ontario
ONTARIO MINIST HLTH & LONG TERM CARE	Ontario
ONTARIO PUBL HLTH ASSOC	Ontario
ONTARIO PUBL HLTH LAB	Ontario
ONTARIO TOBACCO RES UNIT	Ontario
ONTARIO VET COLL	Ontario
PEEL PUBL HLTH	Ontario
PETER MACCALLUM CANC INST	Ontario
PETERBOROUGH REG HLTH CTR	Ontario
Queen’s University	Ontario
QUEENS UNIV	Ontario
Royal Military College of Canada (RMCC)	Ontario
RYERSON UNIV	Ontario
Ryerson University	Ontario
S MICHAELS HOSP	Ontario
SCARBOROUGH GEN HOSP	Ontario
SICKKIDS	Ontario
SICKKIDS HOSP	Ontario
SICKKIDS RES INST	Ontario
ST MICHAEL S HOSP	Ontario
ST MICHAELS HOSP	Ontario
SUNNYBROOK HLTH SCI	Ontario
SUNNYBROOK HLTH SCI CTR INDEPENDENT LIVING	Ontario
SUNNYBROOK ODETTE CANC CTR	Ontario
SUNNYBROOK WOMENS HLTH CTR	Ontario
THUNDER BAY DIST HLTH UNIT	Ontario
THUNDER BAY REG HLTH SCI CTR	Ontario
TORONTO BRAIN VASC MALFORMAT STUDY GRP	Ontario
TORONTO CTR PHENOGEN	Ontario
TORONTO E COUNSELLING & SUPPORT SERV	Ontario
TORONTO E GEN & ORTHOPED HOSP	Ontario
TORONTO HLTH ECON & TECHNOL ASSESSMENT COLLABORAT	Ontario
TORONTO INST PHARMACEUT TECHNOL	Ontario
TORONTO LUNG TRANSPLANT PROGRAM	Ontario
TORONTO MED DISCOVERY TOWER	Ontario
TORONTO PLATELET IMMUNOBIOL GRP	Ontario
TORONTO PUBL HLTH	Ontario
TORONTO REHAB	Ontario
TORONTO REHAB INST	Ontario
TORONTO REHABIL	Ontario
TORONTO REHABIL INST	Ontario
TORONTO RES INST	Ontario
TORONTO SEMI	Ontario
TORONTO SUNNYBROOK REG CANC CTR	Ontario
TRENT UNIV	Ontario
Trent University	Ontario
TRILLIUM HLTH CTR	Ontario
UHN TORONTO GEN HOSP	Ontario
UHN WOMENS HLTH PROGRAM	Ontario
UNIV HEATH NETWORK	Ontario
UNIV HLTH NETWORK	Ontario
UNIV HLTH NETWORK REHABIL SOLUT	Ontario
UNIV HLTH NETWORK TORONTO	Ontario
UNIV QUERYOF TORONTO	Ontario
UNIV VICTORIA	Ontario
UNIV WATERLOO	Ontario
UNIV WESTERN ONTARIO	Ontario
UNIV WINDSOR	Ontario
University of Guelph	Ontario
University of Ontario Institute of Technology	Ontario
University of Ottawa	Ontario
University of Toronto	Ontario
University of Waterloo	Ontario
University of Windsor	Ontario
VEIN INST TORONTO	Ontario
WESTERN GEN HOSP	Ontario
Western University	Ontario
WILFRID LAURIER UNIV	Ontario
Wilfrid Laurier University	Ontario
WOMENS COLL HOSP	Ontario
YORK REG HLTH SERV	Ontario
YORK UNIV	Ontario
York University	Ontario
ACADIA UNIV	Canada
ALBERTA CANC BOARD	Canada
ALBERTA CHILDRENS PROV GEN HOSP	Canada
ALBERTA HLTH & WELLNESS	Canada
ALBERTA PROV LAB	Canada
ARTHRIT RES CTR CANADA	Canada
ARTHRITIS RES CTR CANADA	Canada
BISHOPS UNIV	Canada
BRANDON UNIV	Canada
BRITISH COLUMBIA CANC AGCY	Canada
BRITISH COLUMBIA CTR DIS CONTROL	Canada
CANADA ARTHRIT COMMUNITY RES & EVALUAT UNIT	Canada
CANADA CLIN TRIALS GRP	Canada
CANADA HLTH INFOWAY	Canada
CANADIAN BLOOD SERV	Canada
CANADIAN CANC SOC	Canada
CANADIAN FORCES BASE	Canada
CANADIAN FORCES HLTH SERV	Canada
CANADIAN HLTH SERV RES FDN	Canada
CANADIAN IMMUNODEFICIENCY RES COLLABORAT	Canada
CANADIAN INST HLTH INFORMAT	Canada
CANADIAN INST HLTH RES	Canada
CANADIAN MEM CHIROPRACT COLL	Canada
CANADIAN PARTNERSHIP CANC	Canada
CANADIAN PARTNERSHIP CANCER	Canada
CANADIAN PHYSIOTHERAPY ASSOC	Canada
CANADIAN SCI CTR HUMAN & ANIM HLTH	Canada
CANADIAN THORAC SOC	Canada
CANADIAN TUMOUR REPOSITORY NETWORK	Canada
CANADIAN WORKING GRP HIV & REHABIL	Canada
CANC COUNCIL VICTORIA	Canada
CAPE BRETON UNIV	Canada
CHILDRENS & WOMENS HLTH CTR BRITISH COLUMBIA	Canada
CISTI (Canada Institute for Scientific and Technical Information)	Canada
CONCORDIA UNIV	Canada
CONCORDIA UNIV	Canada
CRIR CONSTANCE LETHBRIDGE REHABIL CTR	Canada
CROHNS & COLITIS FDN CANADA	Canada
CRULRG UNIV LAVAL	Canada
DALHOUSIE UNIV	Canada
DALHOUSIE UNIV	Canada
DEF RES & DEV CANADA	Canada
DR EVERETT CHALMERS REG HOSP	Canada
DR H BLISS MURPHY CANC CTR	Canada
ECOLE POLYTECH MONTREAL	Canada
GENOM LSSU	Canada
GENOM RES LAB	Canada
GENOME ALBERTA	Canada
GENOME CANADA	Canada
GENOME QUEBEC INNOVAT CENTRE	Canada
GENOME QUEBEC INNOVAT CTR	Canada
GENOME QUEBEC INNVOAT CTR	Canada
HEALING HANDS HAITI TEAM CANADA HEALING HANDS	Canada
HEALTHY ENVIRONM & CONSUMER SAFETY BRANCH	Canada
HEART & STROKE FDN	Canada
HEART & STROKE FDN CTR STROKE RECOVERY	Canada
HEART & STROKE RICHARD LEWAR CTR CARDIOVASC EXCEL	Canada
HEART & STROKE RICHARD LEWAR CTR EXCELLENCE	Canada
HEART & STROKE RICHARD LEWAR CTR EXCELLENCE CARDI	Canada
HEC MONTREAL	Canada
HLTH CANADA	Canada
HLTH PROTECT AGCY	Canada
HLTH QUAL COUNCIL	Canada
INST UNIV CARDIOL & PNEUMOL QUEBEC	Canada
MANITOBA CTR HLTH POLICY	Canada
MANITOBA INST CELL BIOL	Canada
MCGILL UNIV	Canada
MEM HOSP	Canada
MEM UNIV NEWFOUNDLAND	Canada
MEM UNIV NEWFOUNDLAND	Canada
MT ALLISON UNIV	Canada
MT ST VINCENT UNIV	Canada
NATL CANC INST CANADA	Canada
NATL RES COUNCIL CANADA	Canada
NATL RES COUNCIL CANADA	Canada
OSTEOPOROSIS CANADA	Canada
PROV LAB PUBL HLTH ALBERTA	Canada
PUBL HLTH AGCY CANADA	Canada
SASKATCHEWAN DIS CONTROL LAB	Canada
SASKATOON HLTH REG	Canada
SIMON FRASER UNIV	Canada
ST FRANCIS XAVIER UNIV	Canada
ST MARYS UNIV	Canada
TEAM CANADA HEALING HANDS	Canada
UNIV ALBERTA	Canada
UNIV ALBERTA	Canada
UNIV BRITISH COLUMBIA	Canada
UNIV BRITISH COLUMBIA	Canada
UNIV CALGARY	Canada
UNIV CALGARY	Canada
UNIV FRASER VALLEY	Canada
UNIV LAVAL	Canada
UNIV LAVAL	Canada
UNIV LAVAL HOSP RES CTR CRCHUL	Canada
UNIV LAVAL ROBERT GIFFORD	Canada
UNIV LETHBRIDGE	Canada
UNIV MANITOBA	Canada
UNIV MONCTON	Canada
UNIV MONTREAL	Canada
UNIV MONTREAL	Canada
UNIV NEW BRUNSWICK	Canada
UNIV NORTH BRITISH COLUMBIA	Canada
UNIV OTTAWA	Canada
UNIV PRINCE EDWARD ISL	Canada
UNIV PRINCE EDWARD ISL	Canada
UNIV QUEBEC	Canada
UNIV QUEBEC	Canada
UNIV QUEBEC CHICOUTIMI	Canada
UNIV QUEBEC MONTREAL	Canada
UNIV QUEBEC TROIS RIVIERES	Canada
UNIV REGINA	Canada
UNIV SASKATCHEWAN	Canada
UNIV SASKATCHEWAN	Canada
UNIV SHERBROOKE	Canada
UNIV VICTORIA	Canada
UNIV VICTORIA	Canada
UNIV WINNIPEG	Canada
VANCOUVER COASTAL HLTH	Canada
VANCOUVER COASTAL HLTH AUTHOR	Canada
VICTORIA HEART INST FDN	Canada
VICTORIA RES LAB CTR	Canada
VON CANADA	Canada
WESTERN RESERVE CARE SYST	Canada
WESTERN UNIV HLTH SCI	Canada
ADELPHI UNIV	United States
ALABAMA A&M UNIV	United States
ALLIANT INT UNIV	United States
AMER ASSOC ADVANCEMENT SCI	United States
AMER CANC SOC	United States
AMER CHRON PAIN ASSOC	United States
AMER COLL MED GENET	United States
AMER COLL RADIOL	United States
AMER RADIOL SERV	United States
AMER RADIOL SERV INC	United States
AMER TYPE CULTURE COLLECT	United States
AMERICAN UNIV	United States
AMES NATL LAB	United States
AMES RES CTR	United States
ANDREWS UNIV	United States
ANTIOCH UNIV NEW ENGLAND	United States
APPALACHIAN STATE UNIV	United States
ARGONNE NATL LAB	United States
ARIZONA ALZHEIMERS CONSORTIUM	United States
ARIZONA STATE UNIV	United States
ASSOC AMER MED COLL	United States
AUBURN UNIV	United States
AUSTIN HLTH	United States
AUSTIN HOSP	United States
BALL STATE UNIV	United States
BAPTIST CARDIAC & VASC INST	United States
BAPTIST HOSP MIAMI	United States
BARUCH COLL (CUNY)	United States
BAYLOR COLL MED	United States
BAYLOR INST REHABIL	United States
BAYLOR RES INST	United States
BAYLOR SAMMONS CANC CTR	United States
BAYLOR UNIV	United States
BAYSTATE HLTH & TUFTS UNIV	United States
BAYSTATE HLTH SYST	United States
BELLEVUE HOSP CTR	United States
BENAROYA RES INST VIRGINIA MASON	United States
BETH ISRAEL DEACONESS MED CTR	United States
BIOLA UNIV	United States
BIRMINGHAM WOMENS HOSP HEALTHCARE	United States
BIRMINGHAM WOMENS HOSP HEALTHCARE NHS TRUST	United States
BOISE STATE UNIV	United States
BOSTON BIOMED RES INST	United States
BOSTON COLL	United States
BOSTON HEALTHCARE SYST VET AFFAIRS MED CTR	United States
BOSTON SCI	United States
BOSTON UNIV	United States
BOSTON UNIV BIOINFORMAT	United States
BOWLING GREEN STATE UNIV	United States
BRANDEIS UNIV	United States
BRIGHAM YOUNG UNIV	United States
BROAD INST	United States
BROAD INST HARVARD	United States
BROAD INST HARVARD & MIT	United States
BROAD INST MIT & HARVARD	United States
BROOKHAVEN NATL LAB	United States
BROOKLYN COLL (CUNY)	United States
BROWN UNIV	United States
BURNS & ALLEN CEDARS SINAI RES INST	United States
CALIF INST REGENERAT MED	United States
CALIF PACIFIC MED CTR	United States
CALIF STATE UNIV FRESNO	United States
CALIF STATE UNIV FULLERTON	United States
CALIF STATE UNIV LONG BEACH	United States
CALIF STATE UNIV LOS ANGELES	United States
CALIF STATE UNIV NORTHRIDGE	United States
CALIF STATE UNIV SACRAMENTO	United States
CALTECH	United States
CAMBRIDGE CTR	United States
CAMBRIDGE INST MED RES	United States
CAMBRIDGE SYST BIOL CTR	United States
CARLETON COLL	United States
CARMEL HOSP	United States
CARMEL MED CTR & B RAPPAPORT	United States
CARNEGIE INST WASHINGTON	United States
CARNEGIE MELLON UNIV	United States
CASE WESTERN RESERVE UNIV	United States
CATHOLIC UNIV AMER	United States
CEDARS SINAI MED CTR	United States
CENT MICHIGAN UNIV	United States
CHILDRENS HOSP BOSTON	United States
CHILDRENS HOSP PHILADELPHIA	United States
CHILDRENS HOSP PITTSBURGH	United States
CHILDRENS HOSP WESTMEAD	United States
CHILDRENS MEM HLTH INST	United States
CHILDRENS MEM HOSP	United States
CHILDRENS NATL MED CTR	United States
CINCINNATI CHILDRENS HOSP	United States
CINCINNATI CHILDRENS HOSP RES FDN	United States
CITY OF HOPE	United States
CLAREMONT GRAD SCH	United States
CLARK ATLANTA UNIV	United States
CLARK UNIV	United States
CLARKSON UNIV	United States
CLEMSON UNIV	United States
CLEVELAND CLIN CANADA	United States
CLEVELAND CLIN FDN	United States
CLEVELAND CLIN FLORIDA	United States
CLEVELAND CLIN I32	United States
CLEVELAND STATE UNIV	United States
COLD SPRING HARBOR LAB	United States
COLL WILLIAM & MARY	United States
COLORADO SCHOOL MINES	United States
COLORADO STATE UNIV	United States
COLUMBIA UNIV	United States
COLUMBIA UNIV TEACHERS COLL	United States
CORNELL UNIV	United States
CREIGHTON UNIV	United States
CUNY GRAD SCH	United States
CUNY SYSTEM	United States
DANA FABER CANC INST	United States
DANA FARBER CANC CTR	United States
DANA FARBER CANC INST	United States
DARTMOUTH COLL	United States
DE PAUL UNIV	United States
DREXEL UNIV	United States
DUKE UNIV	United States
DUQUESNE UNIV	United States
E CAROLINA UNIV	United States
E TENNESSEE STATE UNIV	United States
EASTERN MICHIGAN UNIV	United States
EDWARD MALLINCKRODT INST RADIOL	United States
EMORY UNIV	United States
EUNICE KENNEDY SHRIVER NATL INST CHILD HLTH & HUM	United States
FAIRFIELD UNIV	United States
FED RESERVE SYSTEM	United States
FERMI NATL ACC LAB	United States
FLORIDA ATLANTIC UNIV	United States
FLORIDA GULF COAST UNIV	United States
FLORIDA INST TECHNOL	United States
FLORIDA INT UNIV	United States
FLORIDA STATE UNIV	United States
FORDHAM UNIV	United States
FOX CHASE CANC CTR	United States
FRED HUTCHINSON CANC CTR	United States
GATES FDN	United States
GEISINGER MED CTR	United States
GEISINGER MED INST	United States
GEISINGER NEUROSCI INST	United States
GEORGE MASON UNIV	United States
GEORGE WASHINGTON UNIV	United States
GEORGETOWN UNIV	United States
GEORGIA INST TECHNOL	United States
GEORGIA SO UNIV	United States
GEORGIA STATE UNIV	United States
GLENN RES CTR	United States
GODDARD SPACE FLIGHT CTR	United States
GRAND VALLEY STATE UNIV	United States
HACKENSACK UNIV	United States
HACKENSACK UNIV MED CTR	United States
HARVARD UNIV	United States
HOFSTRA UNIV	United States
HOWARD UNIV	United States
HUMBOLDT STATE UNIV	United States
HUNTER COLL (CUNY)	United States
IDAHO NATL LAB	United States
IDAHO STATE UNIV	United States
ILLINOIS INST TECHNOL	United States
ILLINOIS STATE UNIV	United States
INDIANA STATE DEPT TOXICOL	United States
INDIANA STATE UNIV	United States
INDIANA UNIV	United States
INDIANA UNIV PENN	United States
INDIANA UNIV PURDUE UNIV	United States
INDIANA UNIV-PURDUE UNIV INDIANAPOLIS	United States
INTER AMER UNIV PUERTO RICO	United States
IOWA CITY VA MED CTR	United States
IOWA STATE UNIV	United States
JACKSON LAB	United States
JACKSON STATE UNIV	United States
JAMES MADISON UNIV	United States
JEFFERSON NATL ACC	United States
JET PROP LAB	United States
JHU APPL PHYS LAB	United States
JJ PETERS VET ADM HOSP	United States
JOHNS HOPKINS ONCOL CTR	United States
JOHNS HOPKINS SCH MED BALTIMORE	United States
JOHNS HOPKINS UNIV	United States
JOHNSON & JOHNSON CONSUMER PROD INC	United States
JOHNSON NUTR SOLUT	United States
JOHNSON SPACE FLIGHT CTR	United States
JOINT CLIN RES CTR	United States
JONSSON COMPREHENS CANC CTR	United States
KANSAS STATE UNIV	United States
KANSAS STATE UNIV AGR & APPL SCI	United States
KENNEDY GALTON CTR	United States
KENNEDY KRIEGER INST	United States
KENNEDY LODGE LONG TERM CARE CTR	United States
KENT STATE UNIV	United States
LAMAR UNIV	United States
LANGLEY RES CTR	United States
LAWRENCE BERKELEY NATL LAB	United States
LAWRENCE LIVERMORE NATL LAB	United States
LEHIGH UNIV	United States
LINCOLN LAB	United States
LOMA LINDA UNIV	United States
LONG ISL JEWISH MED CTR	United States
LONG ISLAND UNIV-BROOKLYN CAMPUS	United States
LOS ALAMOS NATL LAB	United States
LOUISIANA STATE UNIV	United States
LOUISIANA TECH UNIV	United States
LOYOLA MARYMOUNT UNIV	United States
LOYOLA UNIV CHICAGO	United States
MAINE CARDIOL ASSOCIATES	United States
MARINE BIOL LAB	United States
MARQUETTE UNIV	United States
MARSHALL SPACE FLIGHT CTR	United States
MASSACHUSETTS GEN HOSP	United States
MASSACHUSETTS GEN HOSP CHILDREN	United States
MAYO	United States
MAYO CLIN & MAYO FDN	United States
MED COLL GEORGIA	United States
MED COLL WISCONSIN	United States
MED UNIV S CAROLINA	United States
MEM SLOAN KETTERING CANC CTR	United States
MERCER UNIV	United States
METHODIST HOSP	United States
MIAMI CHILDRENS HOSP	United States
MIAMI UNIV	United States
MICHAEL SMITH FDN HLTH RES	United States
MICHIGAN STATE UNIV	United States
MICHIGAN TECHNOL UNIV	United States
MIDDLE TENNESSEE STATE UNIV	United States
MILWAUKEE CTY CIRCUIT COURT BRANCH	United States
MILWAUKEE CTY MED EXAMINERS OFF	United States
MISSISSIPPI STATE UNIV	United States
MISSOURI UNIV SCI & TECHNOL	United States
MIT	United States
MOL DIAGNOST CHILDRENS HOSP WISCONSIN	United States
MONTANA STATE UNIV	United States
MOREHOUSE SCH MED	United States
MT SINAI SCH MED	United States
MT ST VINCENT UNIV	United States
N CAROLINA STATE UNIV	United States
N DAKOTA STATE UNIV FARGO	United States
N SHORE LONG ISL JEWISH HLTH SYST	United States
N SHORE UNIV HLTH SYST	United States
NASA	United States
NATL ENERGY TECH LAB	United States
NATL LOUIS UNIV	United States
NATL RENEWABLE ENERGY LAB	United States
NAVAL RES LAB	United States
NCAR (NATL CTR ATMOSPHERIC RES)	United States
NEW BRUNSWICK LAB	United States
NEW ENGLAND RES INST	United States
NEW JERSEY INST TECHNOL	United States
NEW MEXICO INST MIN TECHNOL	United States
NEW MEXICO STATE UNIV	United States
NEW MEXICO VET AFFAIRS HLTH CARE SYST	United States
NEW SCH SOCIAL RES	United States
NEW YORK MED COLL	United States
NEW YORK PRESBYTERIAN HOSP	United States
NEW YORK STATE CTR EXCELLENCE BIOINFORMAT & LIFE	United States
NEW YORK STATE DEPT HLTH	United States
NEW YORK UNIV	United States
NIST	United States
NO ARIZONA UNIV	United States
NO ILLINOIS UNIV	United States
NOAA (NATL OCEANIC ATMOSPHERIC ADMIN)	United States
NORFOLK & NORWICH UNIV HOSP	United States
NORFOLK & NORWICH UNIV HOSP NATL HLTH SERV TRUST	United States
NORTHEASTERN OHIO UNIV COLL MED & PHARM	United States
NORTHEASTERN UNIV	United States
NORTHSHORE UNIV HEALTHSYST	United States
NORTHSHORE UNIV HLTH SYST	United States
NORTHWESTERN UNIV	United States
NOVA SE UNIV	United States
NW MEM HOSP	United States
NYU HOSP JOINT DIS	United States
OAK RIDGE NATL LAB	United States
OAKLAND UNIV	United States
OHIO STATE UNIV	United States
OHIO UNIV	United States
OKLAHOMA STATE UNIV	United States
OLD DOMINION UNIV	United States
OREGON HLTH SCI UNIV	United States
OREGON STATE UNIV	United States
PACE UNIV	United States
PACIFIC NW LAB	United States
PENN STATE UNIV	United States
PEPPERDINE UNIV	United States
POLYTECH INST NYU	United States
POLYTECH UNIV PUERTO RICO	United States
PONTIFICIAL CATHOLIC UNIV PUERTO RICO	United States
PORTLAND STATE UNIV	United States
PRINCETON PHYSICS LAB	United States
PRINCETON UNIV	United States
PURDUE UNIV	United States
QUEENS COLL NY (CUNY)	United States
RADIOL ASSOCIATES CENT FLORIDA	United States
RADIOL CONSULTANTS FORUM HLTH	United States
REED COLL	United States
RENSSELAER POLYTECH INST	United States
RICE UNIV	United States
ROCHESTER INST TECHNOL	United States
ROCKEFELLER UNIV	United States
RUSH UNIV	United States
RUTGERS STATE UNIV	United States
RUTGERS STATE UNIV NEWARK	United States
S CAROLINA STATE UNIV	United States
S DAKOTA STATE UNIV	United States
SALK INST	United States
SAM HOUSTON STATE UNIV	United States
SAN DIEGO STATE UNIV	United States
SAN FRANCISCO STATE UNIV	United States
SAN JOSE STATE UNIV	United States
SANDIA NATL LAB	United States
SANFORD BURNHAM MED RES INST	United States
SAVANNAH COLL ART & DESIGN	United States
SCRIPPS RES INST	United States
SEATTLE BIOMED RES INST	United States
SEATTLE CHILDRENS HOSP	United States
SEATTLE GENET	United States
SEATTLE RADIOLOGISTS	United States
SETON HALL UNIV	United States
SMITHSONIAN INST	United States
SO ILLINOIS UNIV	United States
SO METHODIST UNIV	United States
SOUTHAMPTON GEN HOSP	United States
ST JOHNS UNIV	United States
ST LOUIS UNIV	United States
STANFORD LIN ACCEL CTR	United States
STANFORD UNIV	United States
STEVENS INST TECHNOL	United States
SUNY ALBANY	United States
SUNY BINGHAMTON	United States
SUNY BUFFALO	United States
SUNY COLL ENV SCI FOREST	United States
SUNY DOWNSTATE MED CTR	United States
SUNY STONY BROOK	United States
SUNY SYSTEM	United States
SUNY UPSTATE MED CTR	United States
SYRACUSE UNIV	United States
TEMPLE UNIV	United States
TENNESSEE STATE UNIV	United States
TEXAS A&M HLTH SCI CTR	United States
TEXAS A&M UNIV	United States
TEXAS A&M UNIV COLLEGE STN	United States
TEXAS A&M UNIV COMMERCE	United States
TEXAS A&M UNIV KINGSVILLE	United States
TEXAS A&M UNIV SYSTEM	United States
TEXAS CHILDRENS HOSP	United States
TEXAS CHRISTIAN UNIV	United States
TEXAS HEART INST	United States
TEXAS MED CTR LIB	United States
TEXAS SCOTTISH RITE HOSP CHILDREN	United States
TEXAS SO UNIV	United States
TEXAS STATE UNIV SAN MARCOS	United States
TEXAS STATE UNIV SYSTEM	United States
TEXAS TECH UNIV	United States
TEXAS TECH UNIV HLTH SCI CTR	United States
TEXAS WOMANS UNIV	United States
THOMAS JEFFERSON UNIV	United States
TUFTS UNIV	United States
TULANE UNIV	United States
UC BERKELEY	United States
UC IRVINE	United States
UC SAN DIEGO	United States
UCL	United States
UNIFORMED SERV UNIV HLTH SCI	United States
UNION INST	United States
UNIV AKRON	United States
UNIV ALABAMA	United States
UNIV ALABAMA BIRMINGHAM	United States
UNIV ALABAMA HUNTSVILLE	United States
UNIV ALABAMA SYSTEM	United States
UNIV ALABAMA TUSCALOOSA	United States
UNIV ALASKA ANCHORAGE	United States
UNIV ALASKA FAIRBANKS	United States
UNIV ARIZONA	United States
UNIV ARKANSAS	United States
UNIV ARKANSAS FAYETTEVILLE	United States
UNIV ARKANSAS LITTLE ROCK	United States
UNIV ARKANSAS MED SCI	United States
UNIV ARKANSAS SYSTEM	United States
UNIV BRIDGEPORT	United States
UNIV CALIF BERKELEY	United States
UNIV CALIF DAVIS	United States
UNIV CALIF IRVINE	United States
UNIV CALIF LOS ANGELES	United States
UNIV CALIF MERCED	United States
UNIV CALIF RIVERSIDE	United States
UNIV CALIF SAN DIEGO	United States
UNIV CALIF SAN FRANCISCO	United States
UNIV CALIF SANTA BARBARA	United States
UNIV CALIF SANTA CRUZ	United States
UNIV CALIF SYSTEM	United States
UNIV CENT FLORIDA	United States
UNIV CHICAGO	United States
UNIV CINCINNATI	United States
UNIV COLORADO BOULDER	United States
UNIV COLORADO DENVER	United States
UNIV COLORADO HLTH SCI CTR	United States
UNIV COLORADO SYSTEM	United States
UNIV CONNECTICUT	United States
UNIV DAYTON	United States
UNIV DELAWARE	United States
UNIV DENVER	United States
UNIV DETROIT MERCY	United States
UNIV FLORIDA	United States
UNIV GEORGIA	United States
UNIV HARTFORD	United States
UNIV HAWAII	United States
UNIV HAWAII MANOA	United States
UNIV HAWAII SYSTEM	United States
UNIV HOUSTON	United States
UNIV IDAHO	United States
UNIV ILLINOIS	United States
UNIV ILLINOIS CHICAGO	United States
UNIV ILLINOIS SPRINGFIELD	United States
UNIV ILLINOIS SYSTEM	United States
UNIV ILLINOIS URBANA-CHAMPAIGN	United States
UNIV IOWA	United States
UNIV KANSAS	United States
UNIV KENTUCKY	United States
UNIV LA VERNE	United States
UNIV LOUISIANA LAFAYETTE	United States
UNIV LOUISVILLE	United States
UNIV MAINE	United States
UNIV MARYLAND	United States
UNIV MARYLAND BALTIMORE COUNTY	United States
UNIV MARYLAND COLLEGE PARK	United States
UNIV MASS AMHERST	United States
UNIV MASS BOSTON	United States
UNIV MASS LOWELL	United States
UNIV MASS SYSTEM	United States
UNIV MASS WORCESTER	United States
UNIV MASSACHUSETTS SYST	United States
UNIV MED	United States
UNIV MED & DENT NEW JERSEY	United States
UNIV MED CTR	United States
UNIV MED CTR II	United States
UNIV MED DENT NEW JERSEY	United States
UNIV MEMPHIS	United States
UNIV MIAMI	United States
UNIV MICHIGAN	United States
UNIV MINNESOTA	United States
UNIV MISSISSIPPI	United States
UNIV MISSOURI	United States
UNIV MISSOURI COLUMBIA	United States
UNIV MISSOURI KANSAS CITY	United States
UNIV MISSOURI ST LOUIS	United States
UNIV MISSOURI SYSTEM	United States
UNIV MONTANA	United States
UNIV N CAROLINA	United States
UNIV N CAROLINA CHAPEL HILL	United States
UNIV N CAROLINA GREENSBORO	United States
UNIV N DAKOTA GRAND FORKS	United States
UNIV N TEXAS DENTON	United States
UNIV N TEXAS HLTH SCI CTR	United States
UNIV N TEXAS SYSTEM	United States
UNIV NEBRASKA	United States
UNIV NEBRASKA LINCOLN	United States
UNIV NEBRASKA OMAHA	United States
UNIV NEBRASKA SYSTEM	United States
UNIV NEVADA	United States
UNIV NEVADA LAS VEGAS	United States
UNIV NEVADA RENO	United States
UNIV NEW HAMPSHIRE	United States
UNIV NEW MEXICO	United States
UNIV NEW ORLEANS	United States
UNIV NO COLORADO	United States
UNIV NORTH CAROLINA CHARLOTTE	United States
UNIV NORTH CAROLINA WILMINGTON	United States
UNIV NOTRE DAME	United States
UNIV OKLAHOMA	United States
UNIV ORANGE FREE STATE	United States
UNIV OREGON	United States
UNIV PACIFIC	United States
UNIV PENN	United States
UNIV PITTSBURGH	United States
UNIV PUERTO RICO	United States
UNIV PUERTO RICO RIO PIEDRAS	United States
UNIV RHODE ISLAND	United States
UNIV ROCHESTER	United States
UNIV S ALABAMA	United States
UNIV S CAROLINA	United States
UNIV S DAKOTA	United States
UNIV S FLORIDA	United States
UNIV SAN DIEGO	United States
UNIV SAN FRANCISCO	United States
UNIV SARASOTA	United States
UNIV SO CALIF	United States
UNIV SO FLORIDA	United States
UNIV SO MISSISSIPPI	United States
UNIV ST THOMAS	United States
UNIV SUNSHINE COAST	United States
UNIV TENNESSEE	United States
UNIV TENNESSEE KNOXVILLE	United States
UNIV TEXAS ARLINGTON	United States
UNIV TEXAS AUSTIN	United States
UNIV TEXAS DALLAS	United States
UNIV TEXAS EL PASO	United States
UNIV TEXAS HLTH SCI CTR HOUSTON	United States
UNIV TEXAS HLTH SCI CTR SAN ANTONIO	United States
UNIV TEXAS MED BRANCH GALVESTON	United States
UNIV TEXAS SAN ANTONIO	United States
UNIV TEXAS SCH PUBLIC HEALTH	United States
UNIV TEXAS SW MED CTR DALLAS	United States
UNIV TOLEDO	United States
UNIV TOLEDO HLTH SCI CAMPUS	United States
UNIV TULSA	United States
UNIV UTAH	United States
UNIV VERMONT	United States
UNIV VIRGINIA	United States
UNIV WASHINGTON	United States
UNIV WASHINGTON SEATTLE	United States
UNIV WISCONSIN	United States
UNIV WISCONSIN MADISON	United States
UNIV WISCONSIN MILWAUKEE	United States
UNIV WISCONSIN PARKSIDE	United States
UNIV WISCONSIN SYSTEM	United States
UNIV WYOMING	United States
UPSTATE MED UNIV SUNY	United States
URBAN HARVEST CIP	United States
URBAN HARVEST CIP SSA	United States
US AIR FORCE	United States
US ARMY	United States
US DEPT DEF	United States
US ENVIRONM PROTECT AGCY DURHAM	United States
US EPA	United States
US FDA	United States
US NATL CANC INST	United States
US NATL INST HLTH	United States
US NAVY	United States
US NCI	United States
USDA (US DEPT AGR)	United States
USN MED ONCOL	United States
UT SOUTHWESTERN MED CTR	United States
UTAH STATE UNIV	United States
UTAH VALLEY REG MED CTR	United States
UTMD ANDERSON CANC CTR	United States
VALPARAISO UNIV	United States
VAMC BOSTON	United States
VANDERBILT UNIV	United States
VILLANOVA UNIV	United States
VIRGINIA COMMONWEALTH UNIV	United States
VIRGINIA POLYTECH INST	United States
W VIRGINIA UNIV	United States
WAKE FOREST UNIV	United States
WALDEN UNIV	United States
WASHBURN UNIV	United States
WASHINGTON CTR CLIN RES	United States
WASHINGTON HOSP	United States
WASHINGTON STATE UNIV	United States
WASHINGTON UNIV	United States
WAYNE STATE UNIV	United States
WEBSTER UNIV	United States
WESTERN MICHIGAN UNIV	United States
WESTERN WASHINGTON UNIV	United States
WHITEHEAD INST	United States
WICHITA STATE UNIV	United States
WIDENER UNIV	United States
WILMINGTON COLL	United States
WOODS HOLE OCEANOG INST	United States
WORCESTER POLYTECH INST	United States
WRIGHT STATE UNIV DAYTON	United States
YALE UNIV	United States
YESHIVA UNIV	United States
YORK COLL NY (CUNY)	United States
UNIV BATNA	International
1 DECEMBRIE 1918 UNIV ALBA IULIA	International
29 MAYIS HASTANESI	International
AALBORG & AARHUS UNIV	International
AALBORG UNIV	International
AALTO UNIV	International
AARHUS UNIV	International
ABANT IZZET BAYSAL UNIV	International
ABDUL WALI KHAN UNIV	International
ABERYSTWYTH UNIV	International
ABO AKAD UNIV	International
ABO AKADEMI UNIV	International
ABU DHABI UNIV	International
ACAD ATHENS	International
ACAD FINE ARTS & DESIGN BRATISLAVA	International
ACAD FINE ARTS PRAGUE	International
ACAD MED CTR AMSTERDAM	International
ACAD MIL MED SCI	International
ACAD PERFORMING ARTS PRAGUE	International
ACAD PUBLIC ADMIN	International
ACAD SCI CZECH REPUBL	International
ACAD SINICA	International
ACIBADEM HASTANELERI	International
ACIBADEM UNIV	International
ADALET BAKANLIGI	International
ADAM MICKIEWICZ UNIV	International
ADAMJEE GOVT SCI COLL	International
ADANA NUMUNE EAH	International
ADIYAMAN UNIV	International
ADNAN MENDERES UNIV	International
ADOLFO LUTZ INST	International
AFYON KOCATEPE UNIV	International
AGA KHAN UNIV	International
AGCY SCI TECHNOL & RES A STAR	International
AGCY SCI TECHNOL RES	International
AGENSI NUKLEAR MALAYSIA	International
AGH UNIV SCI & TECHNOL	International
AGHARKAR RES INST	International
AGR INST SLOVENIA	International
AGR MECH RES INST	International
AGR RES INST TAIWAN	International
AGR UNIV ATHENS	International
AGR UNIV KRAKOW	International
AGR UNIV LUBLIN	International
AGR UNIV PESHAWAR	International
AGR UNIV WARSAW	International
AGR UNIV WROCLAW	International
AGRARIAN UNIV	International
AGRESEARCH	International
AGRI DAGI IBRAHIM CECEN UNIV	International
AGRICULTURAL ACAD	International
AGRITEC	International
AHI EVRAN UNIV	International
AICHI CANC CTR	International
AICHI GAKUIN UNIV	International
AICHI MED UNIV	International
AIN SHAMS UNIV	International
AIST	International
AJOU UNIV	International
AKDENIZ UNIV	International
AKITA UNIV	International
AKSARAY UNIV	International
AL IMAM UNIV	International
AL QASSEEM UNIV	International
ALETHEIA UNIV	International
ALEXANDER DUBCEK UNIV TRENCIN	International
ALEXANDRIA UNIV	International
ALEXANDRU IOAN CUZA UNIV	International
ALFAISAL UNIV	International
AL-FARABI KAZAKH NATL UNIV	International
ALIGARH MUSLIM UNIV	International
ALL INDIA INST MED SCI	International
AMASYA UNIV	International
AMER UNIV BULGARIA	International
AMER UNIV CAIRO	International
AMER UNIV SHARJAH	International
AMERICAN UNIV BEIRUT	International
AMERIKAN HASTANESI	International
AMIRKABIR UNIV TECHNOL	International
AMITY UNIV	International
ANADOLU SAGLIK MERKEZI	International
ANADOLU UNIV	International
ANDHRA UNIV	International
ANDONG NATL UNIV	International
ANGLIA RUSKIN UNIV	International
ANHUI MED UNIV	International
ANHUI NORMAL UNIV	International
ANHUI UNIV	International
ANKARA ATATURK EAH	International
ANKARA DISKAPI YILDIRIM BEYAZIT EAH	International
ANKARA DR A YURTARSLAN ONKOLOJI EAH	International
ANKARA EAH	International
ANKARA ETLIK IHTISAS EAH	International
ANKARA KECIOREN EAH	International
ANKARA NUMUNE EAH	International
ANKARA TURKIYE YUKSEK IHTISAS EAH	International
ANKARA ULUCANLAR GOZ EAH	International
ANKARA UNIV	International
ANNA UNIV	International
ANNA UNIV CHENNAI	International
ANNA UNIV TECHNOL CHENNAI	International
ANNA UNIV TECHNOL COIMBATORE	International
ANNA UNIV TECHNOL MADURAI	International
ANNA UNIV TECHNOL TIRUCHIRAPPALLI	International
ANNA UNIV TECHNOL TIRUNELVELI	International
ANTALYA EAH	International
AOYAMA GAKUIN UNIV	International
ARCELIK	International
ARDAHAN UNIV	International
ARID AGR UNIV	International
ARISTOTELIAN UNIV SALONIKA	International
ARISTOTLE UNIV THESSALONIKI	International
ARMED FORCES RES INST MED SCI	International
ARTS UNIV COLL BOURNEMOUTH	International
ARTVIN CORUH UNIV	International
ARYABHATTA RES INST OBSERVAT SCI	International
ASAHI GEN HOSP	International
ASAHI UNIV	International
ASAHIKAWA MED COLL	International
ASELSAN	International
ASIAN DEV BANK	International
ASIAN INST TECHNOL	International
ASKERI HASTANELER	International
ASPETE SCH PEDAG & TECHNOL EDUC	International
ASSIUT UNIV	International
ASTANA MED UNIV	International
ASTON UNIV	International
ATATURK UNIV	International
ATENEO MANILA UNIV	International
ATHENS MED SCH	International
ATHENS SCH FINE ARTS	International
ATHENS UNIV ECON & BUSINESS	International
ATILIM UNIV	International
AUCKLAND HOSP	International
AUCKLAND UNIV TECHNOL	International
AUSTIN RES INST	International
AUSTRALIAN ANIM HLTH LAB	International
AUSTRALIAN CATHOLIC UNIV	International
AUSTRALIAN DEFENSE FORCE ACAD	International
AUSTRALIAN NATL UNIV	International
AUSTRALIAN OVARIAN CANC STUDY GRP	International
AUSTRALIAN STEM CELL CTR	International
AUSTRIAN ACAD SCI	International
AUSTRIAN RES CTR	International
AUT UNIV	International
AVINASHILINGAM UNIV WOMEN	International
AZABU UNIV	International
BAHAUDDIN ZAKARIYA UNIV	International
BAHCESEHIR UNIV	International
BAKER IDI	International
BAKU STATE UNIV	International
BALIKESIR UNIV	International
BANARAS HINDU UNIV	International
BANGALORE UNIV	International
BANGOR UNIV	International
BAQAI MED UNIV	International
BAR ILAN UNIV	International
BARNSLEY HOSP	International
BARTIN UNIV	International
BASBAKANLIK	International
BASKENT UNIV	International
BATH SPA UNIV	International
BATMAN UNIV	International
BAY PLENTY POLYTECH	International
BAYBURT UNIV	International
BAYINDIR HASTANESI	International
BAYINDIRLIK VE ISKAN BAKANLIGI	International
BBSRC BABRAHAM INST	International
BBSRC JOHN INNES CTR	International
BBSRC ROSLIN INST	International
BEIHANG UNIV	International
BEIJING FORESTRY UNIV	International
BEIJING INST TECHNOL	International
BEIJING INST TRANSFUS	International
BEIJING JIAOTONG UNIV	International
BEIJING NEUROSURG INST	International
BEIJING NORMAL UNIV	International
BEIJING UNIV CHEM TECHNOL	International
BEIJING UNIV POSTS & TELECOMMUN	International
BEIJING UNIV TECHNOL	International
BEIRUT MED CTR	International
BELARUSIAN STATE UNIV	International
BELEDIYELER	International
BELFAST CITY HOSP	International
BEN GURION UNIV	International
BEN GURION UNIV NEGEV	International
BENEMERITA UNIV AUTONOMA PUEBLA	International
BERLIN INST UROL RES	International
BEYKENT UNIV	International
BEZMIALEM UNIV	International
BHABHA ATOM RES CTR	International
BHARATHIAR UNIV	International
BHARATHIDASAN UNIV	International
BILECIK UNIV	International
BILKENT UNIV	International
BINGOL UNIV	International
BIRKBECK UNIV LONDON	International
BIRKBECK UNIV LONDON	International
BIRLA INST TECHNOL & SCI	International
BIRMINGHAM CITY UNIV	International
BITLIS EREN UNIV	International
BOCCONI UNIV	International
BOGAZICI UNIV	International
BOND UNIV	International
BOSE INST	International
BOURNEMOUTH UNIV	International
BOZOK UNIV	International
BRAUNSCHWEIG UNIV TECHNOL	International
BRUNEL UNIV	International
BUCKS NEW UNIV	International
BUDAPEST UNIV TECHNOL & ECON	International
BULGARIAN ACAD SCI	International
BURAPHA UNIV	International
BURSA YUKSEK IHTISAS EAH	International
BUS SCH LAUSANNE	International
CAG UNIV	International
CAIRO UNIV	International
CALISMA VE SOSYAL GUVENLIK BAKANLIGI	International
CAN THO UNIV	International
CANAKKALE ONSEKIZ MART UNIV	International
CANCER RES UK	International
CANKAYA UNIV	International
CANKIRI KARATEKIN UNIV	International
CANTERBURY CHRIST CHURCH UNIV	International
CAPE PENINSULA UNIV TECHNOL	International
CAPITAL MED UNIV	International
CAPITAL NORMAL UNIV	International
CARDIFF METROPOLITAN UNIV	International
CARDIFF UNIV	International
CATHOLIC UNIV KOREA	International
CATHOLIC UNIV LEUVEN	International
CATHOLIC UNIV LOUVAIN	International
CATHOLIC UNIV LUBLIN	International
CATHOLIC UNIV PORTO	International
CATHOLIC UNIV RUZOMBEROK	International
CATHOLIC UNIV SACRED HEART	International
CAWTHRON INST	International
CCAST	International
CELAL BAYAR UNIV	International
CENT CHINA NORMAL UNIV	International
CENT DISEASE CTRL TAIWAN	International
CENT EUROPEAN UNIV	International
CENT IRON & STEEL RES INST	International
CENT LUZON STATE UNIV	International
CENT MANCHESTER UNIV HOSP	International
CENT MANCHESTER UNIV HOSP NHS FDN TRUST	International
CENT QUEENSLAND UNIV	International
CENT RES INST ELECT POWER IND	International
CENT S UNIV	International
CENT SCH SPEECH & DRAMA	International
CENT UNIV VENEZUELA	International
CENTRAL UNIV TECHNOL	International
CERN	International
CEVRE VE ORMAN BAKANLIGI	International
CHA HOSP	International
CHALMERS UNIV TECHNOL	International
CHANG GUNG INST TECHNOL	International
CHANG GUNG UNIV	International
CHANG JUNG CHRISTIAN UNIV	International
CHANGE FDN	International
CHANGHUA CHRISTIAN HOSP	International
CHANGWON NATL UNIV	International
CHARITE	International
CHARITE MED UNIV BERLIN	International
CHARITE UNIV MED BERLIN	International
CHARITE UNIV MED CTR	International
CHARLES DARWIN UNIV	International
CHARLES STURT UNIV	International
CHARLES UNIV PRAGUE	International
CHENGDU UNIV TECHNOL	International
CHEST DIS RES INST	International
CHIANG MAI UNIV	International
CHIBA INST TECHNOL	International
CHIBA UNIV	International
CHILD MED RES INST	International
CHINA ACAD ENGN PHYS	International
CHINA AGR UNIV	International
CHINA EARTHQUAKE ADM	International
CHINA INST ATOM ENERGY	International
CHINA MED UNIV	International
CHINA MED UNIV - TAIWAN	International
CHINA MED UNIV TAIWAN	International
CHINA METEOROL ADM	International
CHINA PHARMACEUT UNIV	International
CHINA UNIV GEOSCI	International
CHINA UNIV MIN & TECHNOL	International
CHINA UNIV PETR	International
CHINESE ACAD AGR SCI	International
CHINESE ACAD FORESTRY	International
CHINESE ACAD GEOL SCI	International
CHINESE ACAD MED SCI PEKING UNION MED CO	International
CHINESE ACAD MED SCI PEKING UNION MED COLL	International
CHINESE ACAD SCI	International
CHINESE ACAD SOCIAL SCI	International
CHINESE CTR DIS CONTROL & PREVENT	International
CHINESE CULTURE UNIV	International
CHINESE UNIV HONG KONG	International
CHONBUK NATL UNIV	International
CHONDROMETRICS GMBH	International
CHONGQING MED UNIV	International
CHONGQING UNIV	International
CHONGQING UNIV POSTS & TELECOMMUN	International
CHONNAM NATL UNIV	International
CHOSUN UNIV	International
CHRISTCHURCH POLYTECH	International
CHRU LILLE	International
CHU	International
CHU ANGERS	International
CHU ARNAUD VILLENEUVE	International
CHU BICETRE	International
CHU KREMLIN BICETRE	International
CHU LE KREMLIN BICETRE	International
CHU LYON	International
CHU PELLEGRIN	International
CHU REIMS	International
CHU ST ETIENNE	International
CHU TIMONE	International
CHU TOULOUSE	International
CHU TOULOUSE RANGUEIL	International
CHU VAUDOIS	International
CHUBU UNIV	International
CHULABHORN RES INST	International
CHULALONGKORN UNIV	International
CHUNG ANG UNIV	International
CHUNG HUA UNIV	International
CHUNG SHAN MED UNIV	International
CHUNG YUAN CHRISTIAN UNIV	International
CHUNGBUK NATL UNIV	International
CHUNGNAM NATL UNIV	International
CHUO UNIV	International
CITY UNIV HONG KONG	International
CITY UNIV LONDON	International
CMCH VELLORE	International
CNR	International
COLEGIO POSTGRAD	International
COLL MEXICO	International
COMENIUS UNIV BRATISLAVA	International
CONSEJO NACL INVEST CIENT & TECN	International
CONSTANTINE PHILOSOPHER UNIV NITRA	International
COPENHAGEN BUSINESS SCH	International
CORVINUS UNIV BUDAPEST	International
COVENTRY UNIV	International
CRACOW UNIV TECHNOL	International
CRANFIELD UNIV	International
CROATIAN ACAD SCI & ARTS	International
CSIC	International
CSIR - SOUTH AFRICA	International
CSIR INDIA	International
CSIR REG RES LAB	International
CSIRO	International
CTA	International
CTR BRASILEIRO PESQUISAS FIS	International
CTR CELLULAR & MOL BIOL	International
CTR ELECT ENGN RES INST	International
CTR ELECTROCHEM RES INST	International
CTR FOOD TECHNOL RES INST	International
CTR GLASS & CERAM RES INST	International
CTR HLTH EVALUAT & OUTCOME SCI	International
CTR HOSP LE VINATIER	International
CTR HOSP REG TROIS RIVIERES	International
CTR HOSP ST ANNE	International
CTR HOSP UNIV DIJON	International
CTR HOSP UNIV LIMOGES	International
CTR HOSP UNIV ST JUSTINE	International
CTR HOSP VERSAILLES	International
CTR INST MED & AROMAT PLANTS	International
CTR INST MIN & FUEL RES	International
CTR INVEST BIOMED RED ENFERMEDADES RARAS CIBERERE	International
CTR INVEST PRINCIPE FELIPE	International
CTR JEAN PERRIN	International
CTR LEATHER RES INST	International
CTR LEON BERARD	International
CTR LUTTE CANC GEORGES FRANCOIS LECLERC	International
CTR MATH MODELING & COMP SIMULAT	International
CTR MED GENET	International
CTR MOL DESIGN & PREFORMULAT	International
CTR NATL GENOTYPAGE	International
CTR NATL RECH SCI URA 2578	International
CTR NEUROSCI & CELL BIOL	International
CTR OSCAR LAMBRET	International
CTR PAUL STRAUSS	International
CTR REG LUTTE CANC VAL DAURELLE	International
CTR REGENERAT MED BARCELONA	International
CTR REGENERAT THERAPIES DRESDEN	International
CTR RENE HUGUENIN	International
CTR RES NEURODEGENERAT DIS	International
CTR RIFERIMENTO ONCOL	International
CTR SALT & MARINE CHEM RES INST	International
CTR STUDIO & PREVENZ ONCOL	International
CTR VAL AURELLE	International
CUKUROVA UNIV	International
CUMHURBASKANLIGI	International
CUMHURIYET UNIV	International
CURTIN UNIV TECHNOL	International
CURTIN UNIV TECHNOL SARAWAK	International
CZECH ACAD SCI	International
CZECH DAIRY RES INST	International
CZECH GEOLOGICAL SURVEY	International
CZECH HYDROMETEOROLOGICAL INST	International
CZECH METROLOGY INST	International
CZECH TECH UNIV PRAGUE	International
CZECH UNIV LIFE SCI PRAGUE	International
DA YEH UNIV	International
DALARNA UNIV	International
DALIAN MARITIME UNIV	International
DALIAN MED UNIV	International
DALIAN UNIV TECHNOL	International
DANISH CANC SOC	International
DANKOOK UNIV	International
DAQING PETR INST	International
DARMSTADT UNIV TECHNOL	International
DE LA SALLE UNIV	International
DE MONTFORT UNIV	International
DEAKIN UNIV	International
DELFT UNIV TECHNOL	International
DEMOCRITUS UNIV THRACE	International
DENIZ HARP OKULU KOMUTANLIGI	International
DENIZ KUVVETLERI KOMUTANLIGI	International
DEPT MINERAL RESOURCES	International
DERNEK VE VAKIFLAR	International
DEUTSCH KREBSFORSCHUNGSZENTRUM DFKZ	International
DEVI AHILYA UNIV	International
DEVLET HASTANELERI	International
DEVLET PLANLAMA TESKILATI	International
DEWSBURY & DIST HOSP	International
DICLE UNIV	International
DIGER DEVLET KURULUSLARI	International
DIGER FIRMALAR	International
DIGER OZEL HASTANELER	International
DIJON UNIV HOSP	International
DIWAN COLL MANAGEMENT	International
DIYARBAKIR EAH	International
DOGU AKDENIZ UNIV	International
DOGUS UNIV	International
DOKKYO UNIV	International
DOKUZ EYLUL UNIV	International
DONG A UNIV	International
DONGGUK UNIV	International
DONGHUA UNIV	International
DORTMUND UNIV TECHNOL	International
DOSHISHA UNIV	International
DOW UNIV HLTH SCI	International
DR D Y PATIL VIDYAPEETH PUNE	International
DR DANIEL DEN HOED CANC CTR	International
DR MARGARETE FISCHER BOSCH INST CLIN PHARMACOL	International
DSI	International
DUBLIN CITY UNIV	International
DUBLIN INST TECHNOL	International
DUKE NATL UNIV SINGAPORE	International
DUMLUPINAR UNIV	International
DUNAREA DE JOS UNIV GALATI	International
DUNYA GOZ HASTANESI	International
DURBAN UNIV TECHNOL	International
DURHAM UNIV	International
DURHAM UNIV	International
DUZCE UNIV	International
E CHINA INST TECHNOL	International
E CHINA NORMAL UNIV	International
E CHINA UNIV SCI & TECHNOL	International
EA BUKETOV KARAGANDA STATE UNIV	International
EASTERN HLTH	International
EASTERN INST TECHNOL	International
EBERHARD KARLS UNIV TUBINGEN	International
EBS UNIV	International
ECOLE NATL PONTS & CHAUSSEES	International
ECOLE NORMALE SUPER LYON	International
ECOLE POLYTECH	International
ECOLE POLYTECH FED LAUSANNE	International
ECZACIBASI AS	International
EDGE HILL UNIV	International
EDINBURGH COLL ART	International
EDINBURGH CTR TOXICOL	International
EDITH COWAN UNIV	International
EGE UNIV	International
EGERTON UNIV	International
EHIME UNIV	International
EINDHOVEN UNIV TECHNOL	International
ELAZIG EAH	International
ELECT & TELECOMMUN RES INST	International
EMBRAPA	International
EMIRATES AVIATION COLL	International
ENERJI VE TABII KAYNAKLAR BAKANLIGI	International
ENGLISH & FOREIGN LANG UNIV	International
ENS LYON	International
ENS PARIS	International
EOTVOS LORAND UNIV	International
ERASMUS UNIV ROTTERDAM	International
ERCIYES UNIV	International
EREGLI DEMIR CELIK AS	International
ERZINCAN UNIV	International
ERZURUM EAH	International
ERZURUM NUMUNE EAH	International
ESADE	International
ESIC BUSINESS & MARKETING SCH	International
ESKISEHIR OSMANGAZI UNIV	International
ESR	International
ESSEN UNIV HOSP	International
ETH ZURICH	International
ETI HOLDING	International
EURO SOC MED ONCOL	International
EUROPEAN SO OBSERV	International
EUROPEAN UNIV BRETAGNE	International
EWHA WOMANS UNIV	International
FAC MED SAO JOSE DO RIO PRETO	International
FAC MED TOULOUSE	International
FAC UNIV NOTRE DAME PAIX	International
FAMILIAL BREAST CANC PETER MACCALLUM CANC CTR	International
FAR EAST FED UNIV	International
FATIH UNIV	International
FDN ADOLPHE DE ROTHSCHILD	International
FDN ANTONIO PRUDENTE	International
FDN HOSP ALCORCON	International
FDN INST RICOVERO CURA CARATTERE SCI	International
FDN IRCCS IST NAZL TUMORI	International
FDN IRCCS IST NAZL TUMORI INT	International
FDN IRCCS IST NEUROL BESTA	International
FDN IST FDN ITALIANA RICERA CANCRO FIRC ONCOL MOL	International
FDN IST FIRC ONCOL MED	International
FDN IST FIRC ONCOL MOL	International
FDN IST FIRC ONCOL MOLECOLARE	International
FDN JEAN DAUSSET CEPH	International
FDN JIMENEZ DIAZ	International
FDN SANTA LUCIA	International
FED URDU UNIV ARTS SCI & TECHNOL	International
FENG CHIA UNIV	International
FERDOWSI UNIV MASHHAD	International
FERGUSON SMITH CTR CLIN GENEET	International
FERGUSON SMITH CTR CLIN GENET	International
FIRAT UNIV	International
FISHERIES RES AGCY	International
FLINDERS UNIV S AUSTRALIA	International
FLORANCE NIGHTINGALE HASTANELERI	International
FO GUANG UNIV	International
FOOD & NUTR RES INST	International
FOOD RES INST	International
FORD OTOSAN	International
FORESTRY & FOREST PROD RES INST	International
FORTH	International
FOURTH MIL MED UNIV	International
FRAUNHOFER RES CTR IND MATH	International
FREE UNIV BERLIN	International
FREE UNIV BRUSSELS (NOT IDENTIFIED)	International
FRIEDRICH SCHILLER UNIV JENA	International
FU JEN CATHOLIC UNIV	International
FUDAN UNIV	International
FUJIAN MED UNIV	International
FUJIAN NORMAL UNIV	International
FUJITA HLTH UNIV	International
FUKUOKA UNIV	International
FUKUSHIMA MED UNIV	International
FUKUSHIMA UNIV	International
FUKUYAMA UNIV	International
FUNDACAO OSWALDO CRUZ	International
FUZHOU UNIV	International
GADJAH MADA UNIV	International
GAKUSHUIN UNIV	International
GALATASARAY UNIV	International
GANSU AGR UNIV	International
GARVAN INST MED RES	International
GATA	International
GAZI UNIV	International
GAZIANTEP UNIV	International
GAZIOSMANPASA UNIV	International
GDANSK UNIV TECHNOL	International
GEBZE YUKSEK TEKNOLOJI ENSTITUSU	International
GEN RES INST NONFERROUS MET	International
GENEL KURMAY BASKANLIGI	International
GERMAN CANC AID	International
GERMAN CANC RES CTR	International
GERMAN INST HUMAN NUTR	International
GERMAN RES CTR ENVIRONM HLTH	International
GERMAN RES CTR ENVIRONM HLTH GMBH	International
GERMAN SPORT UNIV COLOGNE	International
GGS INDRAPRASTHA UNIV	International
GH ASACHI TECH UNIV	International
GHANA HLTH SERV	International
GHENT UNIV	International
GIFU PHARMACEUT UNIV	International
GIFU UNIV	International
GIRESUN UNIV	International
GIRNE AMERIKAN UNIV	International
GLASGOW CALEDONIAN UNIV	International
GLASGOW ROYAL INFIRM	International
GLASGOW SCH ART	International
GLYNDWR UNIV	International
GNS	International
GOETHE UNIV FRANKFURT	International
GOLDSMITHS UNIV LONDON	International
GOLDSMITHS UNIV LONDON	International
GOMAL UNIV	International
GOMEL STATE UNIV	International
GOVT COLL UNIV FAISALABAD	International
GOVT COLL UNIV LAHORE	International
GRAD UNIV ADV STUDIES	International
GRAZ UNIV TECHNOL	International
GRIFFITH UNIV	International
GUANGDONG UNIV TECHNOL	International
GUANGXI MED UNIV	International
GUANGXI NORMAL UNIV	International
GUANGXI UNIV	International
GUANGZHOU INST BIOMED	International
GUANGZHOU INST HLTH	International
GUANGZHOU MED COLL	International
GUANGZHOU UNIV	International
GUIZHOU UNIV	International
GUJARAT UNIV	International
GULBENKIAN INST SCI	International
GULF UNIV SCI & TECHNOL	International
GUMUSHANE UNIV	International
GUNMA UNIV	International
GUVEN HASTANESI	International
GUYS & ST THOMAS HOSP TRUST	International
GWANGJU INST SCI & TECH	International
GWANGJU INST SCI & TECHNOL	International
GYDNIA MAR UNIV	International
GYEONGSANG NATL UNIV	International
HACETTEPE UNIV	International
HADASSAH UNIV HOSP	International
HADASSAH UNIV MED ORG	International
Haiti 	International
HAITI HOSP APPEAL	International
HAKKARI UNIV	International
HALIC UNIV	International
HALLYM UNIV	International
HALMSTAD UNIV	International
HAMAD MED CORP	International
HAMAMATSU UNIV SCH MED	International
HAMBURG UNIV TECHNOL	International
HAMDARD UNIV	International
HANGZHOU DIANZI UNIV	International
HANGZHOU NORMAL UNIV	International
HANNOVER MED SCH	International
HANOI MED UNIV	International
HANOI NATL UNIV EDUC	International
HANOI UNIV AGR	International
HANOI UNIV OF SCI & TECHNOL	International
HANOI UNIV PHARM	International
HANYANG UNIV	International
HARBIN ENGN UNIV	International
HARBIN INST TECHNOL	International
HARBIN MED UNIV	International
HARBIN NORMAL UNIV	International
HARBIN UNIV SCI & TECHNOL	International
HARITA GENEL KOMUTANLIGI	International
HAROKOPIO UNIV ATHENS	International
HARP AKADEMILERI KOMUTANLIGI	International
HARPER ADAMS UNIV COLL	International
HARRAN UNIV	International
HASSELT UNIV	International
HAVA HARP OKULU KOMUTANLIGI	International
HAVA KUVVETLERI KOMUTANLIGI	International
HAZARA UNIV	International
HEBEI MED UNIV	International
HEBEI NORMAL UNIV	International
HEBEI UNIV	International
HEBEI UNIV SCI & TECHNOL	International
HEBEI UNIV TECHNOL	International
HEBREW UNIV JERUSALEM	International
HEC PARIS	International
HEFEI UNIV TECHNOL	International
HEILONGJIANG UNIV	International
HEINRICH HEINE UNIV DUSSELDORF	International
HELLEN OPEN UNIV	International
HELMHOLTZ ASSOCIATION	International
HENAN NORMAL UNIV	International
HENAN UNIV	International
HENAN UNIV SCI & TECHNOL	International
HERIOT WATT UNIV	International
HIGHER COLL TECHNOL	International
HIROSAKI UNIV	International
HIROSHIMA UNIV	International
HITIT UNIV	International
HITOTSUBASHI UNIV	International
HLTH SCI AUTHOR SINGAPORE	International
HLTH SCI UNIV HOKKAIDO	International
HOCHIMINH CITY UNIV MED & PHARM	International
HOHAI UNIV	International
HOKKAIDO UNIV	International
HOKURIKU UNIV	International
HONG KONG BAPTIST UNIV	International
HONG KONG INST EDUC	International
HONG KONG POLYTECH UNIV	International
HONG KONG SANAT & HOSP	International
HONG KONG UNIV SCI & TECHNOL	International
HONGIK UNIV	International
HOP ALBERT SCHWEITZER	International
HOP ANTOINE BECLERE	International
HOP BEAUJON	International
HOP BICETRE	International
HOP COCHIN	International
HOP DEBROUSSE	International
HOP EDOUARD HERRIOT	International
HOP FOCH	International
HOP HENRI MONDOR	International
HOP HOTEL DIEU	International
HOP JEAN MINJOZ	International
HOP LA PITIE SALPETRIERE	International
HOP LA TIMONE	International
HOP MARIN	International
HOP MARSEILLE TIMONE	International
HOP NECKER ENFANTS MALAD	International
HOP NORD ASSISTANCE PUBL HOP MARSEILLE	International
HOP NOTRE DAME DE BON SECOURS	International
HOP PAUL BROUSSE	International
HOP PELLEGRIN	International
HOP PURPAN	International
HOP ROBERT DEBRE	International
HOP STE JUSTINE GER	International
HOP XAVIER ARNOZAN	International
HOSEI UNIV	International
HOSHI UNIV	International
HOSP CANC AC CAMARGO	International
HOSP CASA SOLLIEVO SOFFERENZA	International
HOSP CIVILS LYON	International
HOSP CIVILS LYON CTR LEON BERARD	International
HOSP CLIN BARCELONA	International
HOSP CLIN FMUSP	International
HOSP CLIN SAN CARLOS	International
HOSP CLIN UNIV	International
HOSP CLIN UNIV LOZANO BLESA	International
HOSP CLINICO SAN CARLOS 28040	International
HOSP DONOSTIA	International
HOSP DR JOSEP TRUETA IDIBGI	International
HOSP EUROPEAN	International
HOSP GEN GRANOLLERS	International
HOSP GEN VALLE HEBRON	International
HOSP INFANT MEXICO FEDER GOMEZ	International
HOSP INFANTI MEXICO FEDER GOMEZ	International
HOSP INFATIL MEXICO FEDERICO GOMEZ	International
HOSP ISRAELITA ALBERT EINSTEIN	International
HOSP LEVANGER	International
HOSP LLOBREGAT	International
HOSP MAR	International
HOSP MONTE NARANCO	International
HOSP NACL CAYETANO HEREDIA	International
HOSP NACL NINOS DR CARLOS SAENZ HERRERA	International
HOSP NAVARRA PATHOL DEPT	International
HOSP PABLO TOBON URIBE	International
HOSP PABLO TOBON URIBE & CLIN MEDELLIN	International
HOSP PEDIAT COIMBRA	International
HOSP RAMON Y CAJAL	International
HOSP REGGIO CALABRIA AZ OSPEDALIERA BIANCHI MELAC	International
HOSP RUBER INT	International
HOSP SANTA CREU & SANT PAU	International
HOSP SANTA CREU I SANT PAU	International
HOSP SAO MARCOL	International
HOSP SAO MARCOS	International
HOSP SICK CHILDREN	International
HOSP SIRIO LIBANES	International
HOSP UNIV BELLVITGE	International
HOSP UNIV LA PAZ	International
HOSP UNIV VIRGEN ROCIO	International
HOSP VIRGEN DEL PUERTO	International
HOUSE EAR RES INST	International
HOUSTON CTR EDUC & RES THERAPEUT	International
HOUSTON HIGH SCH	International
HOWARD FLOREY INST	International
HOWARD HUGHES MED INST	International
HSUAN CHUANG UNIV	International
HUAFAN UNIV	International
HUAQIAO UNIV	International
HUAZHONG AGR UNIV	International
HUAZHONG UNIV SCI & TECHNOL	International
HUBEI NORMAL UNIV	International
HUBEI UNIV	International
HUE UNIV	International
HUMBOLDT UNIV BERLIN	International
HUNAN NORMAL UNIV	International
HUNAN UNIV	International
HUNAN UNIV TECHNOL	International
HUNGARIAN ACAD SCI	International
HYOGO COLL MED	International
I SHOU UNIV	International
IAC	International
IACS JADAVPUR	International
IBARAKI PREFECTURAL HANDICAPPED CHILDRENS CTR	International
IBARAKI UNIV	International
ICELAND HEART ASSOC	International
ICISLERI BAKANLIGI	International
IDC HERZLIYA	International
IDIBELL CATALAN INST ONCOL	International
IGDIR UNIV	International
IISC BANGLORE	International
IIT	International
IIT BOMBAY	International
IIT DELHI	International
IIT GUWAHATI	International
IIT KANPUR	International
IIT KHARAGPUR	International
IIT MADRAS	International
IIT ROORKEE	International
IMMUNOL ASTHMA & ALLERGY RES INST	International
IMPA	International
IMPERIAL COLL LONDON	International
INCAE BUSINESS SCH	International
IND TECHNOL RES INST	International
IND TOXICOL RES CTR	International
INDANIO BIOSCI INC	International
INDIAN AGR RES INST	International
INDIAN ASSOC CULTIVAT SCI	International
INDIAN COUNCIL MED RES	International
INDIAN INST CHEM BIOL	International
INDIAN INST CHEM TECHNOL	International
INDIAN INST GEOMAGNETISM	International
INDIAN INST INTEGRAT MED	International
INDIAN INST PETR	International
INDIAN INST SCI	International
INDIAN NATL ACAD ENGN	International
INDIAN NATL SCI ACAD	International
INDIAN STAT INST	International
INDIAN VET RES INST	International
INDIRA GANDHI CTR ATOM RES	International
INDUSTRIAL RESEARCH	International
INHA UNIV	International
INIA	International
INJE UNIV	International
INNER MONGOLIA NORMAL UNIV	International
INNER MONGOLIA UNIV	International
INNSBRUCK MED UNIV	International
INONU UNIV	International
INSEAD BUS SCH	International
INST ADV STUDIES	International
INST ADV STUDY SCI & TECHNOL	International
INST AERONAUT MAT	International
INST APPL PHYS & COMPUTAT MATH	International
INST BOT	International
INST BUTANTAN	International
INST CANC RES	International
INST CANC RES & ROYAL MARSDEN NHS FDN	International
INST CANCEROL GUSTAVE ROUSSY	International
INST CANCROL GUSTAVE ROUSSY	International
INST CATALA ONCOL	International
INST CHEM TECHNOL PRAGUE	International
INST CLAUDIUS REGAUD	International
INST CLIN EVALUAT SCI	International
INST CLIN MICROBIOL	International
INST COGNIT NEUROSCI	International
INST CRIMINOLOGY	International
INST CT & MRI SCHILLERPK	International
INST DANTE PAZZANESE CARDIOL	International
INST ETUD POLIT PARIS	International
INST EXPT MED	International
INST FRONTIER MED SCI	International
INST FUNDAMENTAL STUDIES	International
INST GENET MOLEC	International
INST GULBENKIAN CIENCIAS	International
INST GUSTAVE ROUSSY	International
INST HEMATOL & BLOOD DIS HOSP	International
INST HEMATOLOGY PRAGUE	International
INST HIMALAYAN BIORESOURCE TECHNOL	International
INST HUMAN GENET	International
INST INCENT HLTH CARE	International
INST INTERREG SANTE IRSA	International
INST J PAOLI I CALMETTES	International
INST JACQUES MONOD	International
INST JANTUNG NEGARA	International
INST JULES BORDET	International
INST LELOIR	International
INST MATHEMATICS VIETNAM	International
INST MED & VET SCI	International
INST MED BIOL 8A BIOMED GROVE	International
INST MET & TECHNOL	International
INST METROPOLITAN SCI MED	International
INST MEXICANO PETR	International
INST MICROBIAL TECHNOL	International
INST MOL BIOTECHNOL GMBH	International
INST MOL MED & GENET	International
INST MOL SCI	International
INST NACL CIENCIAS MED & NUTR SALVADOR ZUBIRAN	International
INST NACL PESQUISAS ESPACIAIS	International
INST NACL REHABIL	International
INST NACL SAUDE DR RICARDO JORGE	International
INST NATL SANTE & RECH MED U751	International
INST NATL SANTE PUBL QUEBEC	International
INST OFTALMOL	International
INST ONCOL	International
INST ONTARIO CANC RES	International
INST PASTEUR	International
INST PASTEUR KOREA	International
INST PASTEUR LILLE	International
INST PATHOL	International
INST PENYELIDIKAN DAN KEMAJUAN PERTANIAN	International
INST PENYELIDIKAN GETAH MALAYSIA	International
INST PENYELIDIKAN HAIWAN	International
INST PENYELIDIKAN PERHUTANAN MALAYSIA	International
INST PENYELIDIKAN PERUBATAN	International
INST PHARMACOL & BIOL STRUCT	International
INST POLITECN NACL	International
INST PREVENT & OCCUPAT MED GERMAN SOCIAL ACCID IN	International
INST RECH ROBERT SAUVE ST & SECURITE TRAVAIL	International
INST SAFE MEDICAT PRACTICES CANADA	International
INST SALUD CARLOS III	International
INST SCI & TECHNOL	International
INST SYST LEVEL INTEGRAT	International
INST TECHNOL COSTA RICA	International
INT ATOM ENERGY AGCY	International
INT HELLEN UNIV	International
INT RICE RES INST	International
INTL ISLAMIC UNIV MALAYSIA	International
IONIAN UNIV	International
IPEN	International
IQRA UNIV	International
IRKUTSK STATE UNIV	International
ISFAHAN UNIV MED SCI	International
ISFAHAN UNIV TECHNOL	International
ISI FDN	International
ISIK UNIV	International
ISLAMIA DEGREE COLL	International
ISLAMIA DEGREE COLL	International
IST EUROPEO ONCOL	International
IST FIRC ONCOL MOL	International
IST NAZL FIS NUCL	International
IST NAZL TUMORI	International
IST NEUROL MEDITERRANEO NEUROMED	International
IST ONCOL VENETO IRCCS	International
IST SCI SAN RAFFAELE	International
IST SUPER SANITA	International
ISTANBUL AREL UNIV	International
ISTANBUL AYDIN UNIV	International
ISTANBUL BAGCILAR EAH	International
ISTANBUL BAKIRKOY DR SADI KONUK EAH	International
ISTANBUL BILGI UNIV	International
ISTANBUL BILIM UNIV	International
ISTANBUL EAH	International
ISTANBUL FATIH SULTAN MEHMET EAH	International
ISTANBUL GOZTEPE EAH	International
ISTANBUL HASEKI EAH	International
ISTANBUL HAYDARPASA NUMUNE EAH	International
ISTANBUL KARTAL DR LUTFI KIRDAR EAH	International
ISTANBUL KULTUR UNIV	International
ISTANBUL OKMEYDANI EAH	International
ISTANBUL RETINA ENSTITUSU	International
ISTANBUL SISLI ETFAL EAH	International
ISTANBUL TAKSIM EAH	International
ISTANBUL TEKNIK UNIV	International
ISTANBUL TICARET UNIV	International
ISTANBUL UMRANIYE EAH	International
ISTANBUL UNIV	International
ISTEC	International
ITA	International
ITALIAN INST TECHNOL	International
ITALIAN NATL CANC INST REGINA ELENA	International
ITM UNIV	International
IUSM IST UNIV SCI MOTORIE	International
IVANE JAVAKHISHVILI TBILISI STATE UNIV	International
IWATE MED UNIV	International
IWATE UNIV	International
IZMIR ATATURK EAH	International
IZMIR BOZYAKA EAH	International
IZMIR EAH	International
IZMIR EKONOMI UNIV	International
IZMIR TEPECIK EAH	International
IZMIR YUKSEK TEKNOLOJI ENSTITUSU	International
J CRAIG VENTER INST	International
JABATAN HUTAN SARAWAK	International
JADAVPUR UNIV	International
JAGIELLONIAN UNIV	International
JAMES COOK UNIV	International
JAMES J PETERS VET AFFAIRS MED CTR	International
JAMES WHITCOMB RILEY HOSP CHILDREN	International
JAMIA HAMDARD UNIV	International
JAMIA MILLIA ISLAMIA	International
JAMSTEC	International
JAN DLUGOSZ UNIV	International
JAN KOCHANOWSKI UNIV	International
JANDARMA GENEL KOMUTANLIGI	International
JANKHARIA IMAGING CTR	International
JAPAN ADV INST SCI & TECHNOL	International
JAPAN ATOM ENERGY AGCY	International
JAPAN SOC PROMOT SCI	International
JAPAN SYNCHROTRON RADIAT RES INST	International
JAPAN WOMENS UNIV	International
JAPANESE FDN CANC RES	International
JAWAHARLAL NEHRU CTR ADV SCI RES	International
JAWAHARLAL NEHRU UNIV	International
JAXA	International
JEJU NATL UNIV	International
JIANGNAN UNIV	International
JIANGSU UNIV	International
JIANGXI NORMAL UNIV	International
JICHI MED UNIV	International
JIKEI UNIV	International
JILIN UNIV	International
JINAN UNIV	International
JINNAH DEGREE COLL WOMEN	International
JISHOU UNIV	International
JIWAJI UNIV	International
JOHANNES GUTENBERG UNIV MAINZ	International
JOHANNES KEPLER UNIV LINZ	International
JONKOPING UNIV	International
JORDAN UNIV SCI & TECHNOL	International
JOSAI UNIV	International
JOSEPH FOURIER UNIV	International
JOSEPHINE NEFKENS INST	International
JOZEF STEFAN INST	International
JPT PEPTIDE TECHNOL GMBH	International
JST	International
JST	International
Jui-Hsuan	International
JULICH RES CTR	International
JUNTENDO UNIV	International
JURAVINSKI CANC CTR	International
JUSTUS LIEBIG UNIV GIESSEN	International
JYVASKYLA UNIV APP SCI	International
KADIR HAS UNIV	International
KAFKAS UNIV	International
KAGAWA UNIV	International
KAGOSHIMA UNIV	International
KAHRAMANMARAS SUTCU IMAM UNIV	International
KAISER PERMANENTE	International
KAISER PERMANENTE NW	International
KAIST	International
KANAGAWA DENT COLL	International
KANAGAWA UNIV	International
KANAZAWA INST TECHNOL	International
KANAZAWA MED UNIV	International
KANAZAWA UNIV	International
KANGWON NATL UNIV	International
KANSAI MED UNIV	International
KANSAI UNIV	International
KAOHSIUNG MED UNIV	International
KAPOSVAR UNIV	International
KARA HARP OKULU KOMUTANLIGI	International
KARA KUVVETLERI KOMUTANLIGI	International
KARABUK UNIV	International
KARADENIZ TEKNIK UNIV	International
KARAKORAM INT UNIV	International
KARAMANOGLU MEHMETBEY UNIV	International
KARATEKIN UNIV	International
KARDIOLOG PRAXIS WURMTAL	International
KARDIOZENTRUM LA PAZ	International
KARL FRANZENS UNIV GRAZ	International
KARLSRUHE INST TECHNOL	International
KARLSTAD UNIV	International
KAROLINSKA INST	International
KAROLINSKA UNIV HOSP	International
KASETSART UNIV	International
KASTAMONU UNIV	International
KATHLEEN CUNINGHAM FDN	International
KAUNAS UNIV TECHNOL	International
KAWASAKAI MED SCH	International
KAYSERI EAH	International
KAZAKH BRITISH TECH UNIV	International
KAZAKH NATL PEDAGOGICAL UNIV	International
KAZAKH NATL TECH UNIV	International
KAZAN FED UNIV	International
KAZAN STATE UNIV	International
KAZIMIERZ WIELKI UNIV	International
KAZUSA DNA RES INST	International
KECK GRAD INST APPL SCI	International
KEELE UNIV	International
KEENAN RES CTR	International
KEIMYUNG UNIV	International
KEIO UNIV	International
KEK	International
KEMENTERIAN KESIHATAN MALAYSIA	International
KENYA GOVT MED RES CTR	International
KFL&A PUBL HLTH	International
KHALIFA UNIV SCI TECHNOL & RES	International
KHON KAEN UNIV	International
KIELCE UNIV TECHNOL	International
KILIS 7 ARALIK UNIV	International
KINEMED LTD	International
KINEXUS BIOINFORMAT CORP	International
KING ABDULAZIZ CITY SCI & TECHNOL	International
KING ABDULAZIZ CITY SCITECHNOL	International
KING ABDULAZIZ MED CITY	International
KING ABDULAZIZ UNIV	International
KING ABDULLAH UNIV SCI & TECHNOL	International
KING EDWARD MEM HOSP	International
KING FAHD UNIV PETR & MINERALS	International
KING FAISAL SPECIALIST HOSP & RES CTR	International
KING FAISAL UNIV	International
KING KHALID EYE SPECIALIST HOSP	International
KING KHALID UNIV	International
KING KHALID UNIV HOSP	International
KING MONGKUTS UNIV TECHNOL (NOT IDENTIFIED)	International
KING MONGKUTS UNIV TECHNOL LADKRABANG	International
KING MONGKUTS UNIV TECHNOL N BANGKOK	International
KING MONGKUTS UNIV TECHNOL THONBURI	International
KING SAUD BIN ABDULAZIZ UNIV HLTH SCI	International
KING SAUD UNIV	International
KINGS COLL HOSP	International
KINGS COLL HOSP NATL HLTH SERV FDN TRUST	International
KINGS COLL LONDON	International
KINGS COLL LONDON BRITISH HEART FDN CTR RES EXCEL	International
KINGSTON REG CANC CTR	International
KINGSTON UNIV	International
KINKI UNIV	International
KIRIKKALE UNIV	International
KIRIKKALE YUKSEK IHTISAS EAH	International
KIRKLARELI UNIV	International
KIRSEHIR AHI EVRAN UNIV	International
KITAMI INST TECHNOL	International
KITASATO UNIV	International
KIZILAY	International
KLINIKEN GEBURTSMED	International
KLINIKEN STADT KOLN	International
KLINIKUM BAYREUTH	International
KLINIKUM EILBEK SCHON KLINIKEN	International
KLINIKUM LUDWIG MAXIMILIANS UNIV MUNCHEN	International
KLINIKUM SCHWABING	International
KOBE GAKUIN UNIV	International
KOBE PHARMACEUT UNIV	International
KOBE UNIV	International
KOC UNIV	International
KOCAELI EAH	International
KOCAELI UNIV	International
KOCHI UNIV	International
KOGAKUIN UNIV	International
KOHAT UNIV SCI & TECHNOL	International
KOKSHETAU STATE UNIV	International
KOLDING SCHOOL DESIGN	International
KOMODO OPENLAB	International
KONAN UNIV	International
KONGJU NATL UNIV	International
KONKUK UNIV	International
KONRAD LORENZ INST EVOLUT & COGNIT RES	International
KONYA MERAM EAH	International
KOOKMIN UNIV	International
KOREA ADV INST SCI & TECHNOL	International
KOREA ATOM ENERGY RES INST	International
KOREA BASIC SCI INST	International
KOREA CTR DIS CONTROL & PREVENT	International
KOREA INST ADV STUDY	International
KOREA INST MACHINERY & MAT	International
KOREA INST SCI & TECH	International
KOREA OCEAN RES & DEV INST	International
KOREA RES INST BIOSCI & BIOTECH	International
KOREA RES INST BIOSCI & BIOTECHNOL	International
KOREA RES INST CHEM TECH	International
KOREA RES INST STAND & SCI	International
KOREA UNIV	International
KOREAN RED CROSS	International
KOREAN STEM CELL RES CTR	International
KOSZALIN UNIV TECHNOL	International
KREMENCHUK MYKHAILO OSTROHRADSKYI NATL U	International
KRISTIANSTAD UNIV	International
KUDRET GOZ HASTANESI	International
KULTUR VE TURIZM BAKANLIGI	International
KUMAMOTO UNIV	International
KUMASI CTR COLLABORAT RES	International
KUNIN LUNENFELD APPL RES UNIT	International
KUNMING MED COLL	International
KUNMING UNIV SCI & TECHNOL	International
KURCHATOV SCI CTR	International
KURUME UNIV	International
KUVEMPU UNIV	International
KUWAIT INST SCI RES	International
KUWAIT UNIV	International
KWAME NKRUMAH UNIV SCI & TECHNOL	International
KWANDONG UNIV	International
KWANGMYOUNG CHEIL WOMENS HOSP	International
KWANGWOON UNIV	International
KWANSEI GAKUIN UNIV	International
KWONDONG UNIV	International
KYORIN UNIV	International
KYOTO INST TECHNOL	International
KYOTO PHARMACEUT UNIV	International
KYOTO PREFECTURAL UNIV	International
KYOTO PREFECTURAL UNIV MED	International
KYOTO UNIV	International
KYUNG HEE UNIV	International
KYUNGPOOK NATL UNIV	International
KYUSHU INST TECHNOL	International
KYUSHU UNIV	International
L.N. GUMILYOV EURASIAN NATL UNIV	International
LA TROBE UNIV	International
LA TROBE UNIV	International
LAB CORP AMER	International
LAB NACL LUZ SINCROTRON	International
LAB NAZL CONSORZIO INTERUNIV BIOTECNOL	International
LAB SANTE PUBL QUEBEC	International
LAGUARDIA COMMUNITY COLL	International
LAHEY CLIN MED CTR	International
LAHORE UNIV MANAGEMENT SCI	International
LANCASTER UNIV	International
LANCASTER UNIV	International
LANDCARE RESEARCH	International
LANDSPITALI LSH	International
LANDSPITALI NATL	International
LANDSPITALI UNIV HOSP	International
LANZHOU UNIV	International
LANZHOU UNIV TECHNOL	International
LASBELA UNIV AGR WATER & MARINE SCI	International
LATINO AMER FAC MED	International
LATVIAN BIOMED RES & STUDY CTR	International
LAUSITZ UNIV APPL SCI	International
LAWSON HLTH INST	International
LAWSON HLTH RES INST	International
LC CAMPBELL COGNIT NEUROL RES UNIT	International
LEATHERHEAD FOOD INT	International
LEEDS METROPOLITAN UNIV	International
LEFKE AVRUPA UNIV	International
LEIDEN UNIV	International
LESLIE DAN FAC PHARM	International
LEXIKOS CORP	International
LI KA SHING CTR	International
LI KA SHING KNOWLEDGE INST	International
LIAOCHENG UNIV	International
LIAONING NORMAL UNIV	International
LIAONING SHIHUA UNIV	International
LIAONING UNIV	International
LIAQUT UNIV MED & HLTH SCI	International
LINCOLN UNIV	International
LINGNAN UNIV	International
LINKOPING UNIV	International
LINNAEUS UNIV	International
LIVERPOOL HOPE UNIV	International
LIVERPOOL JOHN MOORES UNIV	International
LOBACHEVSKY STATE UNIV NIZHNI NOVGOROD	International
LOMONOSOV MOSCOW STATE UNIV	International
LONDON BUSINESS SCH	International
LONDON METROPOLITAN UNIV	International
LONDON RES INST	International
LONDON S BANK UNIV	International
LONDON SCH ECON & POLIT SCI	International
LONDON SCH HYG & TROP MED	International
LOPBURI CANC CTR	International
LOSEV	International
LOUGHBOROUGH UNIV	International
LOUGHBOROUGH UNIV	International
LOVELY PROFESSIONAL UNIV	International
LOYOLA COLL	International
LOYOLA UNIV	International
LRMN	International
LUBLIN UNIV TECHNOL	International
LUCILE PACKARD CHILDRENS HOSP	International
LUDONG UNIV	International
LUDWIG INST CANC RES	International
LUISS GUIDO CARLI UNIV	International
LULEA UNIV TECH	International
LUND UNIV	International
LUTHERAN GEN HOSP	International
LYNDHURST CTR	International
M NENCKI INST EXPTL BIOL	International
M.AUEZOV SOUTH KAZAKH STATE UNIV	International
MAASTRICHT UNIV	International
MACFARLANE BURNET INST MED RES & PUBL HLTH	International
MACQUARIE UNIV	International
MACROGEN INC	International
MAE FAH LUANG UNIV	International
MAEJO UNIV	International
MAHANAKORN UNIV TECHNOL	International
MAHARAJA SAYAJIRAO UNIV BARODA	International
MAHARSHI DAYANAND UNIV	International
MAHASARAKHAM UNIV	International
MAHATMA GANDHI UNIV	International
MAHIDOL UNIV	International
MAKATI MED CTR	International
MALAGHAN INST	International
MALARDALEN UNIV	International
MALAYSIAN PALM OIL BOARD	International
MALAYSIAN RUBBER BOARD	International
MALMO UNIV	International
MALTEPE UNIV	International
MANCHESTER METROPOLITAN UNIV	International
MANCHESTER ROYAL INFIRM	International
MANGOSUTHU UNIV TECHNOL	International
MANIPAL UNIV	International
MANIPUR UNIV	International
MANSOURA UNIV	International
MANUKAU INST TECHNOL	International
MAPUA INST TECHNOL	International
MARCHE POLYTECH UNIV	International
MARGARET HOSP	International
MARIA CURIE SKODOWSKA UNIV	International
MARIA SKLODOWSKA CURIE MEM CANC CTR	International
MARIO NEGRI INST PHARMACOL RES	International
MARITIME UNIV SZCZECIN	International
MARMARA UNIV	International
MARTIN LUTHER UNIV HALLE WITTENBERG	International
MASARYK UNIV BRNO	International
MASDAR INST SCI & TECHNOL	International
MASSEY UNIV	International
MATEJ BEL UNIV	International
MATER MED RES INST	International
MATREGEN	International
MAULANA AZAD MED COLL	International
MAX BELL RES CTR 5R407	International
MAX BERGMANN CTR BIOMAT	International
MAX DELBRUCK CTR MOL MED	International
MAX PLANCK SOCIETY	International
MAXIMA MED CTR	International
MAZANKOWSKI ALBERTA HEART INST	International
MC	International
MCCORMICK CONSULTAT	International
MCEWEN CTR REGENERAT MED	International
MED UNIV GDANSK	International
MED UNIV GRAZ	International
MED UNIV GRAZ MED	International
MED UNIV INNSBRUCK	International
MED UNIV LODZ	International
MED UNIV LUBECK	International
MED UNIV PLEVEN	International
MED UNIV PLOVDIV	International
MED UNIV SILESIA	International
MED UNIV SOFIA	International
MED UNIV VARNA	International
MED UNIV VIENNA	International
MED UNIV WARSAW	International
MED VERSORGUNGSZENTRUM RADIOL	International
MEDICALPARK HASTANELERI	International
MEDIKANA HASTANELERI	International
MEDITERRANEAN INST LIFE SCI	International
MEHARRY MED COLL	International
MEHMET AKIF ERSOY UNIV	International
MEHRAN UNIV ENGN & TECH	International
MEIJI PHARMACEUT UNIV	International
MEIJI UNIV	International
MEIJO UNIV	International
MEIKAI UNIV	International
MELIK SAH UNIV	International
MEMORIAL HASTANESI	International
MENDEL UNIV BRNO	International
MENDELEEV UNIV CHEM TECHNOL	International
MERCY UNIV HOSP	International
MERKEZ BANKASI	International
MERSIN UNIV	International
MESA HASTANELERI	International
METEOROL RES INST	International
METEOROLOGICAL OFF	International
MICROSOFT RES ASIA	International
MIDDELHEIM HOSP	International
MIDDLESEX LONDON HLTH UNIT	International
MIDDLESEX UNIV	International
MIDOHIO CARDIOL & VASC CONSULTANTS	International
MID-SWEDEN UNIV	International
MIE UNIV	International
MIL ACAD VASIL LEVSKI	International
MIL MED ACAD SOFIA	International
MILLENNIUM PHARMACEUT INC	International
MILLER CHILDRENS HOSP HARBOR UCLA	International
MILLI EGITIM BAKANLIGI	International
MIMAR SINAN GUZEL SANATLAR UNIV	International
MINDANAO STATE UNIV	International
MINES PARIS TECH	International
MING CHUAN UNIV	International
MINGDAO UNIV	International
MINIST AGR & COOPERAT	International
MINIST AGR FORESTRY & FISHERIES	International
MINIST HLTH	International
MINIST MINERAL RESOURCES	International
MINIST PUBL HLTH	International
MINZU UNIV CHINA	International
MOHAMMAD ALI JINNAH UNIV	International
MONASH UNIV	International
MONASH UNIV SCH PSYCHOL & PSYCHIAT	International
MONASH UNIV SUNWAY	International
MONTEFIORE MED CTR	International
MONTERREY INST TECH & HIGHER EDUC	International
MORDOVIAN STATE UNIV	International
MOSCOW ENG PHYS INST	International
MOSCOW INST STEEL & ALLOYS	International
MOSCOW MV LOMONOSOV STATE UNIV	International
MOSCOW PHYSICS & TECHNICS INST	International
MOTHER TERESA WOMENS UNIV	International
MRC LAB MOL BIOL	International
MRC LEICESTER	International
MRC NATL INST MED RES	International
MSD AUSTRIA	International
MT DESERT ISL BIOL LAB	International
MT ELIZABETH HOSP	International
MT GORILLA VET PROJECT	International
MTA	International
MUBARAK AL KABEER HOSP	International
MUGLA UNIV	International
MUKOGAWA WOMENS UNIV	International
MULTIMEDIA UNIV	International
MURDOCH CHILD RES INST	International
MURDOCH UNIV	International
MURORAN INST TECHNOL	International
MUS ALPARSLAN UNIV	International
MUSTAFA KEMAL UNIV	International
MYONGJI UNIV	International
N BENGAL UNIV	International
N CHINA ELECT POWER UNIV	International
NAGAOKA UNIV TECHNOL	International
NAGASAKI UNIV	International
NAGOYA CENT HOSP	International
NAGOYA CITY UNIV	International
NAGOYA INST TECHNOL	International
NAGOYA UNIV	International
NAGPUR UNIV	International
NAMIK KEMAL UNIV	International
NANCHANG UNIV	International
NANHUA UNIV	International
NANJING AGR UNIV	International
NANJING FORESTRY UNIV	International
NANJING MED UNIV	International
NANJING NORMAL UNIV	International
NANJING UNIV	International
NANJING UNIV AERONAUT & ASTRONAUT	International
NANJING UNIV SCI & TECHNOL	International
NANJING UNIV TECHNOL	International
NANKAI UNIV	International
NANYANG TECHNOL UNIV	International
NAPIER UNIV	International
NARA INST SCI & TECHNOL	International
NARA MED UNIV	International
NARA WOMENS UNIV	International
NARESUAN UNIV	International
NAT SPORT ACAD	International
NATIONAL GUARD HEALTH AFFAIRS	International
NATIONAL INST FOOD & DRUG CONTROL	International
NATL & UNIV LIB ZAGREB	International
NATL ACAD FINE ARTS	International
NATL ACAD SCI KAZAKHSTAN	International
NATL ACAD SCI UKRAINE	International
NATL ACAD TEATER & FILM ARTS	International
NATL AEROSP LABS	International
NATL AGR RES CTR	International
NATL APP RES LAB	International
NATL ASTRON OBSERV	International
NATL AUTONOMOUS UNIV MEXICO	International
NATL BOT RES INST	International
NATL CANC CTR	International
NATL CANC CTR - KOREA	International
NATL CANC CTR KOREA	International
NATL CANC CTR SINGAPORE	International
NATL CANC INST	International
NATL CANC INST BRAZIL INCA	International
NATL CENT UNIV	International
NATL CEREBRAL & CARDIOVASC CTR	International
NATL CHEM LAB PUNE	International
NATL CHENG KUNG UNIV	International
NATL CHENGCHI UNIV	International
NATL CHI NAN UNIV	International
NATL CHIAO TUNG UNIV	International
NATL CHIAYI UNIV	International
NATL CHUNG CHENG UNIV	International
NATL CHUNG HSING UNIV	International
NATL CNTR PHYS	International
NATL CTR CHILD HLTH DEV	International
NATL CTR EXCELLENCE MOL BIOL	International
NATL CTR GLOBAL HLTH & MED	International
NATL CTR HAEMATOL & TRANSFUSIOL	International
NATL CTR NEUROL & PSYCHIAT	International
NATL DEF ACAD	International
NATL DEF MED COLL	International
NATL DEF UNIV	International
NATL DONG HWA UNIV	International
NATL ECON UNIV	International
NATL ENGN & SCI COMMISS	International
NATL ENVIRONM ENGN RES INST	International
NATL FOOD RES INST	International
NATL FOREST CTR	International
NATL GENET	International
NATL GENET REFERENCE LAB WESSEX	International
NATL GEOPHYS RES INST	International
NATL HLTH & MED RES COUNCIL	International
NATL HLTH RES INST	International
NATL HOSP ORG	International
NATL INST AGR & BIOL	International
NATL INST AGROBIOL SCI	International
NATL INST AGROENVIRONM SCI	International
NATL INST ANIM HLTH	International
NATL INST APP SCI LYON	International
NATL INST BASIC BIOL	International
NATL INST BIOL	International
NATL INST CANC RES	International
NATL INST CHEM	International
NATL INST ENVIRONM STUDIES	International
NATL INST FUS SCI	International
NATL INST GENET	International
NATL INST HLTH & NUTR	International
NATL INST HLTH SCI	International
NATL INST INTERDISCIPLINARY SCI & TECHNOL	International
NATL INST MENTAL HLTH NEUROSCI	International
NATL INST OCEANOG	International
NATL INST PHYSIOL SCI	International
NATL INST RADIOL SCI	International
NATL INST RES & DEV TECH PHYS	International
NATL INST SCI COMMUN & INFORMAT RESOURCES	International
NATL INST SCI TECHNOL & DEV STUDIES	International
NATL INST TECHNOL KARNATAKA	International
NATL KAOHSIUNG UNIV APPL SCI	International
NATL LIBRARY PRAGUE	International
NATL MET LAB	International
NATL MUSEUM PHILIPPINES	International
NATL PHYS LAB - INDIA	International
NATL POLYTECH INST	International
NATL RES FDN	International
NATL RES INST FAMILY PLANNING	International
NATL SCI & TECHNOL DEV AGCY	International
NATL SPORTS ACAD	International
NATL SUN YAT SEN UNIV	International
NATL TAICHUNG UNIV	International
NATL TAIPEI UNIV	International
NATL TAIPEI UNIV TECH	International
NATL TAIWAN NORMAL UNIV	International
NATL TAIWAN OCEAN UNIV	International
NATL TAIWAN UNIV	International
NATL TAIWAN UNIV SCI & TECHNOL	International
NATL TECH UNIV ATHENS	International
NATL TECH UNIV KHARKIV POLYTECH INST	International
NATL TECH UNIV UKRAINE KIEV POLYTEC INST	International
NATL TEXT UNIV	International
NATL TSING HUA UNIV	International
NATL UNIV DEF TECHNOL	International
NATL UNIV IRELAND GALWAY	International
NATL UNIV IRELAND UNIV COLL CORK	International
NATL UNIV KAOHSIUNG	International
NATL UNIV OSTROH ACAD	International
NATL UNIV SCI & TECHNOL	International
NATL UNIV SINGAPORE	International
NATL VET MED INST	International
NATL YANG MING UNIV	International
NAVAL ACAD	International
NAVARRA HLTH SERV OSASUNBIDEA	International
NAVRONGO HLTH RES CTR	International
NCSR DEMOKRITOS	International
NE & N CENT LONDON HLTH PROTECT UNIT	International
NE AGR UNIV	International
NE FORESTRY UNIV	International
NE HILL UNIV	International
NE NORMAL UNIV	International
NED UNIV ENGN & TECHNOL	International
NELSON MANDELA METROPOL UNIV	International
NELSON MARLBOROUGH INST TECHNOL	International
NERC BRITISH ANTARCTIC SURVEY	International
NERC CTR ECOL & HYDROL	International
NESTEC LTD	International
NESTLE RES CTR	International
NETHERLANDS CANC INST	International
NEVSEHIR UNIV	International
NEW BULG UNIV	International
NEWCASTLE CTR LIFE	International
NEWCASTLE TYNE HOSP NHS TRUST	International
NEWCASTLE UNIV	International
NEWCASTLE UPON TYNE HOSP NHS TRUST	International
NEWMAN UNIV COLL	International
NICOLAUS COPERNICUS UNIV	International
NICT	International
NIGDE UNIV	International
NIHON UNIV	International
NIIGATA UNIV	International
NIMS	International
NINGBO UNIV	International
NINGXIA UNIV	International
NIPPON DENT UNIV	International
NIPPON MED SCH	International
NIPPON VET & LIFE SCI UNIV	International
NITEC UNIV	International
NIWA	International
NOGUCHI MEM INST MED RES	International
NORTH WEST UNIV	International
NORTHEASTERN UNIV-CHINA	International
NORTHTEC	International
NORTHUMBRIA UNIV	International
NORTHWESTERN POLYTECH UNIV	International
NORTHWICK PK HOSP & CLIN RES CTR	International
NORWEGIAN INST PUBL HLTH	International
NORWEGIAN RADIUM HOSP	International
NORWEGIAN UNIV SCI & TECHNOL	International
NOTTINGHAM TRENT UNIV	International
NOVA UNIV LISBON	International
NOVOSIBIRSK STATE UNIV	International
NTL AUTONOMOUS UNIV MEXICO	International
NUCL INST AGR	International
NUCL INST AGR & BIOL	International
NUCL INST FOOD & AGR	International
NUI GALWAY	International
NUI MAYNOOTH	International
NW A&F UNIV	International
NW INST NONFERROUS MET RES	International
NW INST NUCL TECHNOL	International
NW NORMAL UNIV	International
NW UNIV XIAN	International
NWFP AGR UNIV PESHAWAR	International
OBIHIRO UNIV AGR & VET MED	International
OBUDA UNIV	International
OCEAN UNIV CHINA	International
OCHANOMIZU UNIV	International
OITA UNIV	International
OKAN UNIV	International
OKAYAMA UNIV	International
OKAYAMA UNIV SCI	International
ONDOKUZ MAYIS UNIV	International
OPEN POLYTECH NEW ZEALAND	International
OPEN UNIV	International
OPOLE UNIV TECHNOL	International
ORDU UNIV	International
OREBRO UNIV	International
ORISSA UNIV AGR TECHNOL	International
ORTA DOGU TEKNIK UNIV	International
OSAKA CITY UNIV	International
OSAKA ELECTROCOMMUN UNIV	International
OSAKA INST TECHNOL	International
OSAKA MED COLL	International
OSAKA MED CTR CANC & CARDIOVASC DIS	International
OSAKA PREFECTURE UNIV	International
OSAKA UNIV	International
OSAKA UNIV EDUC	International
OSAKA UNIV PHARMACEUT SCI	International
OSMANIA UNIV	International
OSMANIYE KORKUT ATA UNIV	International
OTAGO POLYTECH	International
OXFORD BROOKES UNIV	International
OZYEGIN UNIV	International
PAAET	International
PAK MAYA	International
PAKISTAN AGR RES COUNCIL	International
PAKISTAN ATOM ENERGY COMMISS	International
PAKISTAN INST DEV ECON	International
PAKISTAN INST ENGN & APPL SCI	International
PAKISTAN INST MED SCI	International
PAKISTAN INST NUCL SCI & TECH	International
PAKISTAN MED RES COUNCIL	International
PAKISTAN MUSEUM NAT HIST	International
PAKISTAN SCI FDN	International
PALACKY UNIV OLOMOUC	International
PAMUKKALE UNIV	International
PANJABI UNIV	International
PANTEION UNIV	International
PCSIR LAB COMPLEX	International
PCSIR LABS COMPLEX	International
PCSIR LABS KARACHI	International
PEDAG UNIV CRACOW	International
PEKING UNIV	International
PEOPLES FRIENDSHIP UNIV RUSSIA	International
PETER MACCALLUM CANC CTR	International
PETKIM	International
PETROLEUM INST	International
PGIMER CHANDIGARH	International
PHILIPPINE DEPT HLTH	International
PHILIPPINE GEN HOSP	International
PHILIPPINE HEART CTR	International
PHILIPPINE NUCL RES INST	International
PHILIPPINE RICE RES INST	International
PHILIPPS UNIV MARBURG	International
PHOENIX CHILDRENS HOSP	International
PHRAMONGKUTKLAO COLL MED	International
PHYS RES LAB	International
PIERRE & MARIE CURIE UNIV - PARIS 6	International
PIRI REIS UNIV	International
PLANT & FOOD RESEARCH	International
PLOVDIV UNIV	International
POCHON CHA UNIV	International
POLISH ACAD SCI	International
POLITEHN UNIV TIMISOARA	International
POLYMUN SCI IMMUNBIOL FORSCH GMBH	International
POLYTECH COLL VELIKA GORICA	International
POLYTECH KARLOVAC	International
POLYTECH RIJEKA	International
POLYTECH UNIV BUCHAREST	International
POLYTECH UNIV MILAN	International
POLYTECH UNIV TURIN	International
POLYTECH VARAZDIN	International
POLYTECH ZAGREB	International
POMERANIAN MED SCH	International
POMERANIAN MED UNIV	International
POMPEU FABRA UNIV UPF	International
PONDICHERRY UNIV	International
PONTIFIC CATHOL UNIV ARGENTINA	International
PONTIFIC CATHOL UNIV CHILE	International
PONTIFIC CATHOL UNIV VALPARAISO	International
PONTIFIC UNIV CATOL MINAS GERAIS	International
PONTIFIC UNIV CATOL RIO DE JANEIRO	International
PONTIFIC UNIV CATOL RIO GRANDE DO SUL	International
PONTIFIC UNIV JAVERIANA	International
PONTIFICIA UNIV CATOL PERU	International
PORTUGUESE CATHOLIC UNIV	International
POSTECH	International
POSTGRAD INST MED EDUC RES	International
POZNAN UNIV ECON	International
POZNAN UNIV LIFE SCI	International
POZNAN UNIV MED SCI	International
POZNAN UNIV TECHNOL	International
PRESIDENCY COLL	International
PRINCE SONGKLA UNIV	International
PRINCE WALES HOSP	International
PRINCESS ANNE HOSP	International
PRINCESS MARGARET HOSP TORONTO	UNIV TORONTO
PRITZKER SCH MED	International
PROGNOSYS BIOSCI INC	International
PROHLTH CLIN RES CTR	International
PROV LAB PUBL HLTH MICROBIOL	International
PROVIDENCE HLTH CARE	International
PROVIDENCE UNIV	International
PUKYONG NATL UNIV	International
PUNJAB MED COLL	International
PUNJAB UNIV	International
PURDUE PHARMA	International
PUSAN NATL UNIV	International
PUSAT PENYELIDIKAN HUTAN	International
QAFQAZ UNIV	International
QASSIM UNIV	International
QATAR FDN	International
QE II HLTH SCI CTR	International
QEII HLTH SCI CTR	International
QINGDAO UNIV	International
QINGDAO UNIV SCI & TECHNOL	International
QUAID I AZAM UNIV	International
QUAL RISK & PATIENT SAFETY	International
QUANSER INC	International
QUATROS LLC	International
QUEEN ELIZABETH HOSP	International
QUEEN ELIZABETH II CTR CLIN RES	International
QUEEN ELIZABETH II HLTH SCI CTR	International
QUEEN MARGARET UNIV	International
QUEEN MARY UNIV LONDON	International
QUEEN MARY UNIV LONDON	International
QUEEN SILVIA CHILDRENS HOSP	International
QUEENS UNIV BELFAST	International
QUEENSLAND INST MED RES	International
QUEENSLAND UNIV TECHNOL	International
QUFU NORMAL UNIV	International
RADBOUD UNIV NIJMEGEN	International
RADIAT EFFECTS RES FDN	International
RAJAMANGALA UNIV TECHNOL LANNA	International
RAJASTHAN AGR UNIV	International
RAKUNO GAKUEN UNIV	International
RAMATHIBODI HOSP BANGKOK	International
RAMBAM MED CTR	International
RAMKHAMHAENG UNIV	International
RANGSIT UNIV	International
RAPID RESPONSE RADIOTHERAPY PROGRAM	International
RAVISHANKAR UNIV	International
RAWALPINDI MEDICAL COLLEGE	International
READING HOSP MED CTR	International
READING SCI SERV LTD	International
REDEEMERS UNIV	International
REG ENGN COLL	International
REGIONS HOSP	International
REINNERVATE LTD	International
RENMIN UNIV CHINA	International
RES ACTIV TEAM	International
RES BIOMED DEPT	International
RES INST	International
RES INST GROWTH & DEV	International
RES INST MOL PATHOL IMP	International
RES INST MOLEC PATHOL	International
RES INST TROP MED	International
REYKJAVIK UNIV	International
RHEIN WESTFAL TH AACHEN	International
RHODES UNIV	International
RICHARDSON CTR FUNCT FOODS & NUTRACEUT	International
RIGA STRADINS UNIV	International
RIGA TECH UNIV	International
RIGSHOSP	International
RIKEN	International
RIKKYO UNIV	International
RITSUMEIKAN UNIV	International
RIZE EAH	International
RIZE UNIV	International
RMIT	International
ROBERT GORDON UNIV	International
ROCKY MT POISON & DRUG CTR	International
ROEHAMPTON UNIV	International
ROMA TRE UNIV	International
ROMANIAN ACAD SCI	International
ROSKILDE UNIV	International
ROSLIN CELLS	International
ROSWELL PK CANC INST	International
ROTHAMSTED RES	International
ROTTERDAM FAMILY CANC CLIN	International
ROUGE VALLEY HLTH SYST	International
ROYAL AGR COLL	International
ROYAL AGR COLL	International
ROYAL BRISBANE & WOMENS HOSP	International
ROYAL CHILDRENS HOSP MELBOURNE	International
ROYAL COLL ART	International
ROYAL COLL MUS	International
ROYAL COLL SURGEONS IRELAND	International
ROYAL COLUMBIAN HOSP	International
ROYAL DANISH SCH PHARM	International
ROYAL DEVON & EXETER HOSP	International
ROYAL FOREST DEPT	International
ROYAL HOLLOWAY UNIV LONDON	International
ROYAL HOLLOWAY UNIV LONDON	International
ROYAL HOSP SICK CHILDREN	International
ROYAL INFIRM	International
ROYAL INST TECHNOL	International
ROYAL JUBILEE HOSP	International
ROYAL LIVERPOOL UNIV HOSP	International
ROYAL LONDON HOSP	International
ROYAL MARSDEN HOSP	International
ROYAL MARSDEN NHS FDN TRUST	International
ROYAL MELBOURNE HOSP	International
ROYAL N SHORE HOSP	International
ROYAL NATL HOSP RHEUMAT DIS	International
ROYAL NETHERLANDS ACAD ARTS & SCI	International
ROYAL NO COLL MUS	International
ROYAL PERTH HOSP	International
ROYAL PHYSIOTHERAPY CLIN	International
ROYAL PRINCE ALFRED HOSP	International
ROYAL SCH LIB & INFORMAT SCI	International
ROYAL SOC CHEM	International
ROYAL UNIV HOSP	International
ROYAL VICTORIA HOSP	International
ROYAL VICTORIA INFIRM	International
RS MCLAUGHLIN DURHAM REG CANC CTR	International
RTI INT	International
RUDJER BOSKOVIC INST	International
RUHR UNIV BOCHUM	International
RUPRECHT KARL UNIV HEIDELBERG	International
RUSSIAN ACAD MED SCI	International
RUSSIAN ACAD SCI	International
RUSSIAN STATE MED UNIV	International
RWTH AACHEN UNIV	International
RZESZOW UNIV TECHNOL	International
S AFRICAN MRC	International
S AUSTRALIAN CLIN GENET SERV	International
S CHINA AGR UNIV	International
S CHINA NORMAL UNIV	International
S CHINA UNIV TECHNOL	International
S OSTROBOTHNIA CENT HOSP	International
S TOWER MARS DISCOVERY CTR	UNIV TORONTO
S&P ROBOT INC	International
SA PATHOL	International
SAARLAND UNIV	International
SABANCI UNIV	International
SAFAR CTR RESUSCITAT RES	International
SAFRA CHILDRENS HOSP	International
SAGA UNIV	International
SAGLIK BAKANLIGI	International
SAHLGRENS UNIV HOSP	International
SAHLGRENSKA UNIV	International
SAITAMA MED UNIV	International
SAITAMA UNIV	International
SAKARYA EAH	International
SAKARYA UNIV	International
SAKON NAKHON RAJABHAT UNIV	International
SALAAM SHALOM PROD	International
SALFORD ROYAL UNIV TEACHING HOSP	International
SALISBURY DIST HOSP	International
SALK INST BIOL STUDIES	International
SALPETRIERE HOSP	International
SALZBURG UNIV	International
SAMARA STATE UNIV	International
SAMSUN MEHMET AYDIN EAH	International
SAN CAMILLO FORLANINI HOSP	International
SAN PIETRO HOSP	International
SANAYI VE TICARET BAKANLIGI	International
SANDY LAKE HLTH & DIABET PROJECT	International
SANI KONUKOGLU HASTANESI	International
SANLIURFA EAH	International
SANOFI AVENTIS	International
SANOFI AVENTIS CANADA	International
SANTA CLARA UNIV	International
SAPIENZA UNIV ROME	International
SAPPORO MED UNIV	International
SARATOV STATE UNIV	International
SARDAR PATEL UNIV	International
SAUDI ARAMCO	International
SAVUNMA BAKANLIGI	International
SCH MED	International
SCHERING PLOUGH CORP	International
SCHNEIDER CHILDRENS MED CTR ISRAEL	International
SCI & RES UNIV	International
SCI CONSULTING GRP INC	International
SCI SIGNALING	International
SCION	International
SCOTT & WHITE MEM HOSP & CLIN	International
SCOTTISH UNIV RES & REACTOR CTR	International
SCUOLA NORMALE SUPER PISA	International
SE ASIAN FISHERIES DEV CTR	International
SE LONDON HLTH PROTECT UNIT	International
SE LOUISIANA UNIV	International
SEA LANE BIOTECHNOL	International
SECOND MIL MED UNIV	International
SECUGEN SL	International
SEJONG UNIV	International
SELCUK UNIV	International
SEMMELWEIS UNIV	International
SENTINELLE MED	International
SEOUL NATL UNIV	International
SEQUENOM INC	International
SETSUNAN UNIV	International
SGX PHARMACEUT INC	International
SHAANXI NORMAL UNIV	International
SHAARE ZEDEK MED CTR	International
SHAFALLAH MED GENET CTR	International
SHAH ABDUL LATIF UNIV	International
SHAHREKORD UNIV MED SCI	International
SHANDONG AGR UNIV	International
SHANDONG INST LIGHT IND	International
SHANDONG NORMAL UNIV	International
SHANDONG UNIV	International
SHANDONG UNIV SCI & TECHNOL	International
SHANGHAI JIAO TONG UNIV	International
SHANGHAI NORMAL UNIV	International
SHANGHAI UNIV	International
SHANGHAI UNIV SCI & TECHNOL	International
SHANTOU UNIV	International
SHANXI AGR UNIV	International
SHANXI MED UNIV	International
SHANXI NORMAL UNIV	International
SHANXI UNIV	International
SHAOXING COLL ARTS & SCI	International
SHARIF UNIV TECHNOL	International
SHEBA MED CTR	International
SHEFFIELD CHILDRENS HOSP	International
SHEFFIELD HALLAM UNIV	International
SHEILA MACDONALD & ASSOCIATES	International
SHENYANG PHARMACEUT UNIV	International
SHENYANG UNIV TECHNOL	International
SHENZHEN UNIV	International
SHERBROOKE INST PHARMACOL	International
SHI CONSULTING INC	International
SHIBAURA INST TECHNOL	International
SHIFA COLL MED	International
SHIGA UNIV	International
SHIGA UNIV MED SCI	International
SHIH CHIEN UNIV	International
SHIH HSIN UNIV	International
SHIJIAZHUANG TIEDAO UNIV	International
SHIMANE UNIV	International
SHINSHU UNIV	International
SHIRAZ UNIV	International
SHIVAJI UNIV	International
SHIZUOKA UNIV	International
SHOWA UNIV	International
SIBERIAN FED UNIV	International
SICHUAN AGR UNIV	International
SICHUAN NORMAL UNIV	International
SICHUAN UNIV	International
SIEMENS HEALTHCARE	International
SIFA HASTANESI	International
SIIRT UNIV	International
SIIRT UNIV	International
SILESIAN UNIV OPAVA	International
SILESIAN UNIV TECHNOL	International
SILLIMAN UNIV	International
SILPAKORN UNIV	International
SINDH AGR UNIV	International
SINGAPORE GEN HOSP	International
SINGAPORE MANAGEMENT UNIV	International
SINOP UNIV	International
SINOPEC	International
SINT FRANCISCUS HOSP	International
SIR CHARLES GAIRDNER HOSP	International
SIR SYED UNIV ENGN & TECHNOL	International
SIRIM BERHAD	International
SIRNAK UNIV	International
SISE VE CAM FABRIKALARI AS	International
SKANE UNIV HOSP	International
SKARABORG PRIMARY CARE	International
SLOVAK ACAD SCI	International
SLOVAK AGR RES CTR	International
SLOVAK MED UNIV BRATISLAVA	International
SLOVAK NATL LIB MARTIN	International
SLOVAK UNIV AGR NITRA	International
SLOVAK UNIV TECHNOL BRATISLAVA	International
SMBD JEWISH GEN HOSP	International
SN BOSE NATL CTR BASIC SCI	International
SO CROSS UNIV	International
SO FED UNIV	International
SO INST TECHNOL	International
SO MED UNIV	International
SO VALLEY UNIV	International
SODERTORN UNIV COLL	International
SOGANG UNIV	International
SOLAE LLC	International
SOOCHOW UNIV	International
SOOKMYUNG WOMENS UNIV	International
SOONCHUNHYANG UNIV	International
SOONGSIL UNIV	International
SOPHIA UNIV	International
SOUTHAMPTON SOLENT UNIV	International
SOUTHEAST UNIV	International
SOUTHERN MED UNIV	International
SOUTHWEST UNIV	International
SREE CHITRA TIRUNAL INST MED SCI TECHNOL	International
SRI INT	International
SRI VENKATESWARA UNIV	International
SRINAKHARINWIROT UNIV	International
ST BARTHOLOMEWS HOSP	International
ST ELIZABETH HLTH CARE	International
ST ELIZABETH HOSP	International
ST FRANCIS HOSP	International
ST FRANCIS XAVIER UNIV	International
ST FRANCISCUS GASTHUIS	International
ST GEORGES UNIV LONDON	International
ST HLTH COMMUNITY NURSING FDN	International
ST JAMES UNIV HOSP	International
ST JOHNS HOSP	International
ST JOSEPHS CARE GRP	International
ST JOSEPHS HEALTHCARE	International
ST JOSEPHS HEALTHCARE HAMILTON	International
ST JOSEPHS HEALTHCARE LONDON	International
ST JUDE CHILDRENS HOSP	International
ST LOUIS VET ADM MED CTR	International
ST LUKES HOSP	International
ST LUKES MED CTR	International
ST LUKES MID AMER HEART INST	International
ST LUKES ROOSEVELT HOSP	International
ST MARGARET MERCY HOSP	International
ST MARIANNA UNIV	International
ST MARIANNA UNIV	International
ST MARKS HOSP	International
ST MARYS HOSP	International
ST ORSOLA MARCELLO MALPIGHI HOSP	International
ST PETERSBURG STATE POLYTECH UNIV	International
ST PETERSBURG STATE UNIV	International
ST STEPHENS COLL	International
ST VINCENT UNIV HOSP	International
ST VINCENTS HOSP	International
STAFFORDSHIRE UNIV	International
STANDORT MUNCHEN	International
STATE CTR QUAL & CONTROL DRUG	International
STATE HLTH CTR	International
STATE OCEAN ADM	International
STE ANNES HOSP	International
STE JUSTINE HOSP	International
STELLA MARIS INST CHILD & ADOLESCENT NEUROPSYCHIA	International
STELLENBOSCH UNIV	International
STEM CELL NETWORK	International
STFC DARESBURY LAB	International
STFC RUTHERFORD APPLETON LAB	International
STOCKHOLM SCH ECON	International
STOCKHOLM UNIV	International
STOLLERY CHILDRENS HOSP	International
STONY BROOK UNIV MED CTR	International
STRATAS PARTNERS	International
STRUCT BIOL CTR	International
STRUCT ENGINEERING RES CTR	International
STRUCT GENOM CONSORTIUM	International
SUDBURY REG HOSP	International
SULEYMAN DEMIREL UNIV	International
SULTAN QABOOS UNIV	International
SUMMA HLTH SYST	International
SUN HLTH RES INST	International
SUN YAT SEN UNIV	International
SUNCHON NATL UNIV	International
SUNGKYUNKWAN UNIV	International
SUNSHINE COAST UNIV	International
SUNY COLL BROCKPORT	International
SUPARCO	International
SURANAREE UNIV TECHNOL	International
SURATTANI HOSP	International
SUSTAINABLE DEV POLICY INST	International
SUZHOU UNIV	International
SW FORESTRY UNIV	International
SW INST PHYS	International
SW JIAOTONG UNIV	International
SW UNIV	International
SW UNIV FINANCE & ECON	International
SW UNIV NATIONALITIES	International
SW UNIV POLIT SCI & LAW	International
SW UNIV SCI & TECHNOL	International
SWANSEA METROPOLITAN UNIV	International
SWANSEA UNIV	International
SWEDISH UNIV AGR SCI	International
SWINBURNE UNIV TECHNOL	International
SWINBURNE UNIV TECHNOL SARAWAK	International
SWISS FED INST TECHNOL LAUSANNE	International
SWISS FED INST TECHNOL ZURICH	International
SYDNEY CHILDRENS HOSP	International
SYNAPCELL	International
SYNARC	International
SYNGENTA BIOTECH INC	International
SZEGED UNIV	International
SZENT ISTVAN UNIV	International
TAEK	International
TAIPEI MED UNIV	International
TAIWAN FISH RES INST	International
TAIWAN LIVESTOCK RES INST	International
TAIWAN VET GEN HOSP	International
TAIYUAN UNIV TECHNOL	International
TALLINN TECH UNIV	International
TAMIL NADU VET & ANIMAL SCI UNIV	International
TAMKANG UNIV	International
TAMPERE UNIV TECHNOL	International
TARAS SHEVCHENKO NATL UNIV KIEV	International
TARGOS MOL PATHOL GMBH	International
TARIM VE KOY ISLERI BAKANLIGI	International
TATA INST FUND RES	International
TATA INST FUNDAMENTAL RES	International
TATA INST SOCIAL SCI	International
TATA MEM HOSP	International
TATUNG UNIV	International
TBMM	International
TE WANANGA O AOTEAROA	International
TE WHARE WANANGA O AWANUIARANGI	International
TECH UNIV	International
TECH UNIV BERLIN	International
TECH UNIV CLUJ NAPOCA	International
TECH UNIV CRETE	International
TECH UNIV CZESTOCHOWA	International
TECH UNIV DENMARK	International
TECH UNIV DRESDEN	International
TECH UNIV GABROVO	International
TECH UNIV KOSICE	International
TECH UNIV LIBEREC	International
TECH UNIV LODZ	International
TECH UNIV MUNICH	International
TECH UNIV OSTRAVA	International
TECH UNIV PLOVDIV	International
TECH UNIV RADOM	International
TECH UNIV SOFIA	International
TECH UNIV VARNA	International
TECH UNIV ZVOLEN	International
TECHNION ISRAEL INST TECHNOL	International
TECHNION X2013 ISRAEL INST TECHNOL	International
TECNOL ESTUDIOS SUPER ECATEPEC	International
TEHRAN UNIV MED	International
TEHRAN UNIV MED SCI	International
TEIKYO UNIV	International
TEL AVIV MED CTR & SCH MED	International
TEL AVIV SOURASKY MED CTR	International
TEL AVIV UNIV	International
TELECOM PARISTECH ESS	International
TELETHON	International
TELETHON INST GENET & MED	International
TEXAS A&M UNIV QATAR	International
TEZPUR UNIV	International
THAI RED CROSS SOC	International
THAILAND INST SCI & TECHNOL RES	International
THAMES VALLEY CHILDRENS CTR	International
THAMMASAT UNIV	International
THAPAR UNIV	International
THERMOGENESIS CORP	International
THIRD MIL MED UNIV	International
THORAXKLIN UNIV HOSP	International
THRACIAN UNIV STARA ZAGORA	International
TIANJIN MED UNIV	International
TIANJIN NORMAL UNIV	International
TIANJIN POLYTECH UNIV	International
TIANJIN UNIV	International
TILBURG UNIV	International
TOBB EKONOMI VE TEKNOLOJI UNIV	International
TOHO UNIV	International
TOHOKU PHARMACEUT UNIV	International
TOHOKU UNIV	International
TOKAI UNIV	International
TOKUSHIMA BUNRI UNIV	International
TOKYO CITY UNIV	International
TOKYO DENKI UNIV	International
TOKYO DENT COLL	International
TOKYO GAKUGEI UNIV	International
TOKYO INST PSYCHIAT	International
TOKYO INST TECHNOL	International
TOKYO MED & DENT UNIV	International
TOKYO MED UNIV	International
TOKYO METROPOLITAN GERIATR HOSP & INST GERONTOL	International
TOKYO METROPOLITAN INST GERONTOL	International
TOKYO METROPOLITAN INST MED SCI	International
TOKYO METROPOLITAN INST NEUROSCI	International
TOKYO METROPOLITAN INST PUBL HLTH	International
TOKYO METROPOLITAN UNIV	International
TOKYO UNIV AGR	International
TOKYO UNIV AGR & TECHNOL	International
TOKYO UNIV MARINE SCI & TECHNOL	International
TOKYO UNIV PHARM & LIFE SCI	International
TOKYO UNIV SCI	International
TOKYO WOMENS MED UNIV	International
TOMAS BATA UNIV ZLIN	International
TOMSK POLYTECH UNIV	International
TOMSK STATE UNIV	International
TONGJI UNIV	International
TORBAY HOSP	International
TOTTORI UNIV	International
TOULOUSE BUSINESS SCH	International
TOYAMA UNIV	International
TOYOHASHI UNIV TECHNOL	International
TOYOTA TECHNOL INST	International
TPAO	International
TRABZON NUMUNE EAH	International
TRAKYA UNIV	International
TRANSILVANIA UNIV BRASOV	International
TRANSP UNIV	International
TRANSPORT & TELECOM INST	International
TRINITY COLL DUBLIN	International
TSE	International
TSENOV ACAD ECON	International
TSHWANE UNIV TECHNOL	International
TSING HUA UNIV	International
TUBA	International
TUBITAK	International
TUFTS MED CTR	International
TUNCELI UNIV	International
TUNGHAI UNIV	International
TURKIYE KARDIYOLOJI DERNEGI	International
TUSAS	International
TZU CHI UNIV	International
UBON RATCHATHANI UNIV	International
UDON THANI RAJABHAT UNIV	International
UFUK UNIV	International
UHI MILLENNIUM INST	International
UK ATOM ENERGY AUTHOR	International
ULASTIRMA BAKANLIGI	International
ULSAN NATL UNIV SCI & TECHNOL	International
ULUDAG UNIV	International
ULUSLARARASI KIBRIS UNIV	International
UMEA UNIV	International
UNIDADE COAGULOPATIAS HEMOCTR MATO GROSS	International
UNIGENE LABS INC	International
UNILEVER FOOD & HLTH RES INST	International
UNILEVER RES	International
UNITEC NZ	International
UNITED ARAB EMIRATES UNIV	International
UNITED BIOSOURCE CORP	International
UNIV AALBORG	International
UNIV ABERDEEN	International
UNIV ABERTAY DUNDEE	International
UNIV ADELAIDE	International
UNIV AEGEAN	International
UNIV AGR FAISALABAD	International
UNIV AGUASCALIENTES	International
UNIV AIMST	International
UNIV AIX MARSEILLE	International
UNIV AIX MARSEILLE 2	International
UNIV AIX-MARSEILLE	International
UNIV ALGARVE	International
UNIV ALLAHABAD	International
UNIV AMSTERDAM	International
UNIV ANDES CHILE	International
UNIV ANDES COLOMBIA	International
UNIV ANDRES BELLO	International
UNIV ANGERS	International
UNIV ANTIOQUIA	International
UNIV ANTOFAGASTA	International
UNIV ANTWERP	International
UNIV AQUILA	International
UNIV ARCHITECTURE & CIVIL ENGN	International
UNIV ARTOIS	International
UNIV ARTS LONDON	International
UNIV ARTURO PRAT	International
UNIV ATACAMA	International
UNIV ATHENS	International
UNIV AUCKLAND	International
UNIV AUGSBURG	International
UNIV AUSTRAL CHILE	International
UNIV AUTONOMA AGUASCALIENTES	International
UNIV AUTONOMA BAJA CALIFORNIA	International
UNIV AUTONOMA BARCELONA	International
UNIV AUTONOMA CARMEN	International
UNIV AUTONOMA CHIAPAS	International
UNIV AUTONOMA CIUDAD JUAREZ	International
UNIV AUTONOMA COAHUILA	International
UNIV AUTONOMA ESTADO HIDALGO	International
UNIV AUTONOMA ESTADO MEXICO	International
UNIV AUTONOMA ESTADO MORELOS	International
UNIV AUTONOMA GUADALAJARA	International
UNIV AUTONOMA MADRID	International
UNIV AUTONOMA METROPOLITANA	International
UNIV AUTONOMA NEUVO LEON	International
UNIV AUTONOMA NUEVO LEON	International
UNIV AUTONOMA QUERETARO	International
UNIV AUTONOMA SAN LUIS POTOSI	International
UNIV AUTONOMA SINALOA	International
UNIV AUTONOMA TAMAULIPAS	International
UNIV AUTONOMA YUCATAN	International
UNIV AUTONOMA ZACATECAS	International
UNIV AUVERGNE	International
UNIV AVEIRO	International
UNIV AZAD JAMMU & KASHMIR	International
UNIV BABES BOLYAI	International
UNIV BALEARIC ISL	International
UNIV BALLARAT	International
UNIV BALOCHISTAN	International
UNIV BARCELONA	International
UNIV BARI	International
UNIV BASEL	International
UNIV BASQUE COUNTRY	International
UNIV BATH	International
UNIV BATH	International
UNIV BAYREUTH	International
UNIV BEDFORDSHIRE	International
UNIV BELGRADE	International
UNIV BERGAMO	International
UNIV BERGEN	International
UNIV BERN	International
UNIV BIALYSTOK	International
UNIV BICETRE	International
UNIV BIELEFELD	International
UNIV BIELSKO BIALA	International
UNIV BIO BIO	International
UNIV BIRMINGHAM	International
UNIV BODENKULTUR WIEN	International
UNIV BOLOGNA	International
UNIV BOLTON	International
UNIV BONN	International
UNIV BORDEAUX	International
UNIV BORDEAUX 1	International
UNIV BORDEAUX 2	International
UNIV BOURGOGNE	International
UNIV BOURGOGNE - DIJON	International
UNIV BRADFORD	International
UNIV BRASILIA	International
UNIV BREMEN	International
UNIV BRIGHTON	International
UNIV BRISTOL	International
UNIV BUCHAREST	International
UNIV BUCKINGHAM	International
UNIV BUENOS AIRES	International
UNIV BURGAS	International
UNIV BURGONDY	International
UNIV BURGUNDY	International
UNIV BYDGOSZCZ	International
UNIV CA FOSCARI VENEZIA	International
UNIV CAEN	International
UNIV CAGLIARI	International
UNIV CALABRIA	International
UNIV CALCUTTA	International
UNIV CALICUT	International
UNIV CAMBRIDGE	International
UNIV CAMERINO	International
UNIV CAMPUS BIOMED	International
UNIV CANBERRA	International
UNIV CANTERBURY	International
UNIV CAPE COAST	International
UNIV CAPE TOWN	International
UNIV CARLOS III MADRID	International
UNIV CASABLANCA HASSAN 2	International
UNIV CATANIA	International
UNIV CATHOL CORDOBA	International
UNIV CATHOL MAULE	International
UNIV CATHOLIQUE LOUVAIN	International
UNIV CATOL BRASILIA	International
UNIV CATOLICA NORTE	International
UNIV CATOLICA TEMUCO	International
UNIV CATTOLICA SACRO CUORE	International
UNIV CENT GREECE	International
UNIV CENT LANCASHIRE	International
UNIV CENTR PUNJAB	International
UNIV CENTRAL VENEZUELA	International
UNIV CERGY-PONTOISE	International
UNIV CHEM TECHNOL & MET	International
UNIV CHESTER	International
UNIV CHICHESTER	International
UNIV CHILDRENS HOSP	International
UNIV CHILE	International
UNIV CHILE CLIN HOSP	International
UNIV CLAUDE BERNARD - LYON 1	International
UNIV CLIN BONN	International
UNIV CLIN HAMBURG EPPENDORF	International
UNIV COIMBRA	International
UNIV COLIMA	International
UNIV COLL ANTWERP	International
UNIV COLL BIRMINGHAM	International
UNIV COLL CORK	International
UNIV COLL CREATIVE ARTS	International
UNIV COLL DUBLIN	International
UNIV COLL FALMOUTH	International
UNIV COLL HOSP	International
UNIV COLL LONDON	International
UNIV COLOGNE	International
UNIV COLOMBO	International
UNIV COLORADO	International
UNIV COMPLUTENSE MADRID	International
UNIV CONCEPCION	International
UNIV COPENHAGEN	International
UNIV COSTA RICA	International
UNIV CRAIOVA	International
UNIV CRETE	International
UNIV CTR	International
UNIV CUMBRIA	International
UNIV CYPRUS	International
UNIV DANANG	International
UNIV DEBRECEN	International
UNIV DEFENCE	International
UNIV DEL NORTE	International
UNIV DELHI	International
UNIV DERBY	International
UNIV DEUSTO	International
UNIV DRESDEN	International
UNIV DUBROVNIK	International
UNIV DUESSELDORF	International
UNIV DUISBURG ESSEN	International
UNIV DUNDEE	International
UNIV DURHAM	International
UNIV DUSSELDORF	International
UNIV E ANGLIA	International
UNIV E ANGLIA	International
UNIV E LONDON	International
UNIV EAST FINLAND	International
UNIV EASTERN FINLAND	International
UNIV ECON BRATISLAVA	International
UNIV ECON PRAGUE	International
UNIV ECON VARNA	International
UNIV EDINBURGH	International
UNIV EDUC	International
UNIV ELECT SCI & TECHNOL CHINA	International
UNIV ELECTROCOMMUN	International
UNIV ENGN & TECH	International
UNIV ENGN & TECH PRESHAWAR	International
UNIV ENGN & TECH TAXILA	International
UNIV ERLANGEN NUREMBERG	International
UNIV ERLANGEN NURNBERG	International
UNIV ESSEX	International
UNIV ESSEX	International
UNIV ESTADO RIO DE JANEIRO	International
UNIV ESTADUAL CAMPINAS	International
UNIV ESTADUAL MARINGA	International
UNIV ESTADUAL PAULISTA	International
UNIV EXETER	International
UNIV EXETER	International
UNIV EXTREMADURA	International
UNIV EYE HOSP	International
UNIV FED ABC	International
UNIV FED ALAGOAS	International
UNIV FED BAHIA	International
UNIV FED CAMPINA GRANDE	International
UNIV FED CEARA	International
UNIV FED FLUMINENSE	International
UNIV FED GOIAS	International
UNIV FED MINAS GERAIS	International
UNIV FED OURO PRETO	International
UNIV FED PARAIBA	International
UNIV FED PARANA	International
UNIV FED PELOTAS	International
UNIV FED PERNAMBUCO	International
UNIV FED RIO DE JANEIRO	International
UNIV FED RIO GRANDE NORTE	International
UNIV FED RIO GRANDE SUL	International
UNIV FED RURAL RIO DE JANEIRO	International
UNIV FED SANTA CATARINA	International
UNIV FED SANTA MARIA	International
UNIV FED SAO CARLOS	International
UNIV FED SAO PAULO	International
UNIV FED UBERLANDIA	International
UNIV FED VICOSA	International
UNIV FERRARA	International
UNIV FINANCE & ADMINISTRATION	International
UNIV FINANCE & MGMT WARSAW	International
UNIV FLORENCE	International
UNIV FOGGIA	International
UNIV FOOD TECH	International
UNIV FORESTRY	International
UNIV FORT HARE	International
UNIV FRANCOIS RABELAIS - TOURS	International
UNIV FREE STATE	International
UNIV FREIBURG	International
UNIV FRIBOURG	International
UNIV FRONTERA	International
UNIV FUKUI	International
UNIV GDANSK	International
UNIV GEN HOSP	International
UNIV GENEVA	International
UNIV GENOA	International
UNIV GHANA	International
UNIV GHENT VIB	International
UNIV GLAMORGAN	International
UNIV GLASGOW	International
UNIV GLOUCESTERSHIRE	International
UNIV GOTHENBURG	International
UNIV GOTTINGEN	International
UNIV GRANADA	International
UNIV GRAZ	International
UNIV GREENWICH	International
UNIV GRENOBLE	International
UNIV GRENOBLE 1	International
UNIV GRONINGEN	International
"UNIV GRONINGEN, UNIV MED CTR GRONINGEN"	International
UNIV GUADALAJARA	International
UNIV GUJRAT	International
UNIV HAIFA	International
UNIV HAMBURG	International
UNIV HANNOVER	International
UNIV HANOI	International
UNIV HAUTE BRETAGNE - RENNES 2	International
UNIV HEIDELBERG	International
UNIV HELSINKI	International
UNIV HENRI POINCARE - NANCY I	International
UNIV HERTFORDSHIRE	International
UNIV HLTH SCI	International
UNIV HONG KONG	International
UNIV HOSP	International
UNIV HOSP ALEXANDROUPOLIS	International
UNIV HOSP BIRMINGHAM	International
UNIV HOSP BIRMINGHAM NHS FDN TRUST	International
UNIV HOSP CALLE	International
UNIV HOSP CHUV	International
UNIV HOSP CLEVELAND	International
UNIV HOSP CTR VAUDOIS	International
UNIV HOSP GASTHUISBERG	International
UNIV HOSP GREIFSWALD	International
UNIV HOSP LEICESTER NHS TRUST	International
UNIV HOSP MUENSTER	International
UNIV HOSP MUNICH	International
UNIV HOSP N STAFFORDSHIRE	International
UNIV HOSP NETHERLANDS	International
UNIV HOSP OREBRO	International
UNIV HOSP PISA	International
UNIV HOSP S SALVATORE	International
UNIV HOSP SCHLESWIG HOLSTEIN	International
UNIV HOSP SESTRE MILOSRDNICE	International
UNIV HOSP STRASBOURG	International
UNIV HOSP TRUST VERONA	International
UNIV HRADEC KRALOVE	International
UNIV HUDDERSFIELD	International
UNIV HULL	International
UNIV HYDERABAD	International
UNIV HYOGO	International
UNIV IBADAN	International
UNIV IBEROAMER	International
UNIV ICELAND	International
UNIV INDONESIA	International
UNIV INNSBRUCK	International
UNIV INST LISBON	International
UNIV INSUBRIA	International
UNIV IOANNINA	International
UNIV ISLAM ANTARABANGSA MALAYSIA	International
UNIV ISTVAN SZECHENYI	International
UNIV JAMMU	International
UNIV JAN EVANGELISTA PURKYNE	International
UNIV JEAN MONNET	International
UNIV JEAN MOULIN - LYON III	International
UNIV JENA	International
UNIV JINAN	International
UNIV JJ STROSSMAYER OSIJEK	International
UNIV JOHANNESBURG	International
UNIV JORDAN	International
UNIV JUAREZ AUTONOMA TABASCO	International
UNIV JUAREZ ESTADO DURANGO	International
UNIV JURAJ DOBRILA PULA	International
UNIV JYVASKYLA	International
UNIV KAISERSLAUTERN	International
UNIV KALMAR	International
UNIV KARACHI	International
UNIV KEBANGSAAN MALAYSIA	International
UNIV KENT	International
UNIV KERALA	International
UNIV KIEL	International
UNIV KLAGENFURT	International
UNIV KLIN BONN	International
UNIV KLIN RADIOL	International
UNIV KLINIKUM CHARITE	International
UNIV KLINIKUM HALLE	International
UNIV KONSTANZ	International
UNIV KUALA LUMPUR	International
UNIV KUOPIO	International
UNIV KWAZULU NATAL	International
UNIV KWAZULU NATAL S AFRICA	International
UNIV LA ROCHELLE	International
UNIV LAGOS	International
UNIV LAHORE	International
UNIV LANCASTER	International
UNIV LATVIA	International
UNIV LAUSANNE	International
UNIV LE HAVRE	International
UNIV LE MIRAIL - TOULOUSE II	International
UNIV LEEDS	International
UNIV LEICESTER	International
UNIV LEICESTER	International
UNIV LEIPZIG	International
UNIV LEOBEN	International
UNIV LETHBRIDGE	International
UNIV LIB BRATISLAVA	International
UNIV LIBRE BRUSSELS	International
UNIV LIEGE	International
UNIV LILLE	International
UNIV LILLE 2	International
UNIV LILLE I	International
UNIV LILLE II	International
UNIV LILLE III	International
UNIV LILLE NORD DE FRANCE	International
UNIV LIMERICK	International
UNIV LIMOGES	International
UNIV LIMPOPO	International
UNIV LINCOLN	International
UNIV LISBON	International
UNIV LITTORAL	International
UNIV LIVERPOOL	International
UNIV LJUBLJANA	International
UNIV LODZ	International
UNIV LONDON	International
UNIV LONDON COURTAULD INST ART	International
UNIV LONDON HEYTHROP COLL	International
UNIV LONDON IMPERIAL COLL SCI TECHNOL & MED	International
UNIV LONDON INST EDUC	International
UNIV LONDON INST EDUC	International
UNIV LONDON ROYAL ACAD MUS	International
UNIV LONDON ROYAL VET COLL	International
UNIV LONDON SCH PHARM	International
UNIV LONDON SOAS	International
UNIV LONDON SOAS	International
UNIV LORRAINE	International
UNIV LOS ANDES VENEZUELA	International
UNIV LOZANO BLESA	International
UNIV LUBECK	International
UNIV LUCERNE	International
UNIV LUCKNOW	International
UNIV LUGANO	International
UNIV LUMIERE - LYON II	International
UNIV LUND	International
UNIV LYON	International
UNIV LYON CTR LEON BERARD	International
UNIV MAASTRICHT	International
UNIV MACAU	International
UNIV MACEDONIA	International
UNIV MADRAS	International
UNIV MAGALLANES	International
UNIV MAINE - LE MANS	International
UNIV MAINZ	International
UNIV MALAGA	International
UNIV MALAKAND	International
UNIV MALAWI	International
UNIV MALAYA	International
UNIV MALAYSIA PERLIS	International
UNIV MALAYSIA SABAH	International
UNIV MALAYSIA SARAWAK	International
UNIV MALAYSIA TERENGGANU	International
UNIV MALE STERIL CTR	International
UNIV MANCHESTER	International
UNIV MANNHEIM	International
UNIV MARBURG	International
UNIV MARIBOR	International
UNIV MARRAKECH CADI AYYAD	International
UNIV MED CTR HAMBURG EPPENDORF	International
UNIV MEDITERRANEAN - AIX-MARSEILLE II	International
UNIV MELBOURNE	International
UNIV MESSINA	International
UNIV METZ	International
UNIV MICHEL DE MONTAIGNE - BORDEAUX III	International
UNIV MILAN	International
UNIV MILANO BICOCCA	International
UNIV MILANO-BICOCCA	International
UNIV MIN & GEOL	International
UNIV MINHO	International
UNIV MISKOLC	International
UNIV MIYAZAKI	International
UNIV MODENA & REGGIO EMILIA	International
UNIV MOHAMED PREMIER	International
UNIV MOHAMED PREMIER	International
UNIV MOLISE	International
UNIV MONASTIR	International
UNIV MONS	International
UNIV MONTENEGRO	International
UNIV MONTPELLIER 2	International
UNIV MONTPELLIER I	International
UNIV MONTPELLIER II	International
UNIV MONTPELLIER SUD DE FRANCE	International
UNIV MUMBAI	International
UNIV MUNICH	International
UNIV MUNSTER	International
UNIV MURCIA	International
UNIV NACL AUTONOMA MEXICO	International
UNIV NACL COLOMBIA	International
UNIV NACL CORDOBA	International
UNIV NACL CUYO	International
UNIV NACL LA PLATA	International
UNIV NACL LITORAL	International
UNIV NACL LOMAS ZAMORA	International
UNIV NACL MAYOR SAN MARCOS	International
UNIV NACL ROSARIO	International
UNIV NACL SAN LUIS	International
UNIV NAIROBI	International
UNIV NAMUR	International
UNIV NANCY 1	International
UNIV NANCY II	International
UNIV NANTERRE - PARIS X	International
UNIV NANTES	International
UNIV NANTES ANGERS LE MANS - UNAM	International
UNIV NAPLES FEDERICO II	International
UNIV NAT RESOURCES & APPL LIFE SCI	International
UNIV NATL & WORLD ECON	International
UNIV NAVARRA	International
UNIV NEUCHATEL	International
UNIV NEW ENGLAND	International
UNIV NEW S WALES	International
UNIV NEWCASTLE	International
UNIV NEWCASTLE UPON TYNE	International
UNIV NICE - SOPHIA ANTIPOLIS	International
UNIV NORTHAMPTON	International
UNIV NOTTINGHAM	International
UNIV NOTTINGHAM MALAYSIA	International
UNIV NOVA GORICA	International
UNIV NOVA LISBOA	International
UNIV OCCIDENTE	International
UNIV OCCUPAT & ENVIRONM HLTH	International
UNIV OPOLE	International
UNIV OSLO	International
UNIV OSTRAVA	International
UNIV OTAGO	International
UNIV OULU	International
UNIV OVIEDO	International
UNIV OXFORD	International
UNIV PADUA	International
UNIV PALERMO	International
UNIV PANNONIA	International
UNIV PANTHEON SORBONNE - PARIS I	International
UNIV PARDUBICE	International
UNIV PARIS 12 VAL DE MARNE	International
UNIV PARIS 8 VINCENNES-SAINT-DENIS	International
UNIV PARIS DAUPHINE - PARIS IX	International
UNIV PARIS DESCARTES	International
UNIV PARIS DESCARTES - PARIS V	International
UNIV PARIS DIDEROT	International
UNIV PARIS DIDEROT - PARIS VII	International
UNIV PARIS II	International
UNIV PARIS NORD - PARIS XIII	International
UNIV PARIS SORBONNE - PARIS IV	International
UNIV PARIS SUD - PARIS XI	International
UNIV PARIS SUD 11	International
UNIV PARIS SUD ORSAY	International
UNIV PARIS-EST CRETEIL	International
UNIV PARMA	International
UNIV PATRAS	International
UNIV PAU & PAYS ADOUR	International
UNIV PAUL CEZANNE - AIX-MARSEILLE III	International
UNIV PAUL SABATIER - TOULOUSE III	International
UNIV PAUL VALERY - MONTPELLIER III	International
UNIV PAVIA	International
UNIV PAVOL JOZEF SAFARIK KOSICE	International
UNIV PECS	International
UNIV PELOPONNESE	International
UNIV PERADENIYA	International
UNIV PERUANA CAYETANO HEREDIA	International
UNIV PERUBATAN ANTARABANGSA	International
UNIV PERUGIA	International
UNIV PESHAWAR	International
UNIV PHILIPPINES	International
UNIV PHILIPPINES DILIMAN	International
UNIV PHILIPPINES LOS BANOS	International
UNIV PHILIPPINES MANILA	International
UNIV PICARDIE-JULES-VERNE	International
UNIV PIEMONTE ORIENTALE	International
UNIV PIERRE & MARIE CURIE	International
UNIV PIERRE MENDES-FRANCE - GRENOBLE II	International
UNIV PIRAEUS	International
UNIV PISA	International
UNIV PLAYA ANCHA	International
UNIV PLYMOUTH	International
UNIV PODLASIE	International
UNIV POITIERS	International
UNIV POLITECN MARCHE	International
UNIV POLYTECH CATALUNYA	International
UNIV POLYTECH MADRID	International
UNIV POLYTECH VALENCIA	International
UNIV POMPEU FABRA	International
UNIV PORTO	International
UNIV PORTSMOUTH	International
UNIV POTSDAM	International
UNIV PRESBITERIANA MACKENZIE	International
UNIV PRESOVE	International
UNIV PRETORIA	International
UNIV PRIMORSKA	International
UNIV PROVENCE - AIX-MARSEILLE I	International
UNIV PUNE	International
UNIV PUNJAB	International
UNIV PUTRA MALAYSIA	International
UNIV QATAR	International
UNIV QUEENSLAND	International
UNIV QUINTANA ROO	International
UNIV READING	International
UNIV READING	International
UNIV REGENSBURG	International
UNIV REIMS CHAMPAGNE-ARDENNE	International
UNIV RENNES 1	International
UNIV REPUBLIC	International
UNIV RES NETWORK	International
UNIV RESIDENCE NETWORK	International
UNIV RIBEIRAO PRETO	International
UNIV RIJEKA	International
UNIV ROMA LA SAPIENZA	International
UNIV ROMA TOR VERGATA	International
UNIV ROME TOR VERGATA	International
UNIV ROSTOCK	International
UNIV ROUEN	International
UNIV RUSE	International
UNIV RYUKYUS	International
UNIV RZESZOW	International
UNIV S AUSTRALIA	International
UNIV S BOHEMIA	International
UNIV S DENMARK	International
UNIV SAINS MALAYSIA	International
UNIV SALAMANCA	International
UNIV SALENTO	International
UNIV SALERNO	International
UNIV SALFORD	International
UNIV SAN CARLOS	International
UNIV SANTIAGO CHILE	International
UNIV SANTIAGO DE COMPOSTELA	International
UNIV SANTISIMA CONCEPCION	International
UNIV SANTO TOMAS	International
UNIV SAO PAULO	International
UNIV SARGODHA	International
UNIV SASSARI	International
UNIV SCHLESWIG HOLSTEIN	International
UNIV SCI & TECHNOL BANNU	International
UNIV SCI & TECHNOL BEIJING	International
UNIV SCI & TECHNOL CHINA	International
UNIV SCIENCES SOCIALES - TOULOUSE I	International
UNIV SELYE JANOS KOMARNO	International
UNIV SEOUL	International
UNIV SERENA	International
UNIV SEVILLA	International
UNIV SFAX	International
UNIV SHEFFIELD	International
UNIV SHERBROOKE	International
UNIV SHIZUOKA	International
UNIV SHUMEN	International
UNIV SIENA	International
UNIV SILESIA	International
UNIV SIMON BOLIVAR	International
UNIV SINDH	International
UNIV SINOS VALLEY	International
UNIV SKOVDE	International
UNIV SO BRETAGNE	International
UNIV SO DENMARK	International
UNIV SO QUEENSLAND	International
UNIV SOFIA	International
UNIV SONORA	International
UNIV SOPHIA ANTIPOLIS	International
UNIV SORBONNE NOUVELLE - PARIS III	International
UNIV SOUTH AFRICA	International
UNIV SOUTH BOHEMIA CESKE BUDEJOVICE	International
UNIV SOUTHAMPTON	International
UNIV SPLIT	International
UNIV SS CYRIL & METHODIUS TRNAVA	International
UNIV ST ANDREWS	International
UNIV ST ANDREWS	International
UNIV ST ETIENNE	International
UNIV ST GALLEN	International
UNIV STELLENBOSCH	International
UNIV STENDHAL - GRENOBLE III	International
UNIV STIRLING	International
UNIV STRASBOURG	International
UNIV STRASBOURG LARGE	International
UNIV STRATHCLYDE	International
UNIV STUTTGART	International
UNIV SUD TOULON-VAR	International
UNIV SUNDERLAND	International
UNIV SURREY	International
UNIV SURREY	International
UNIV SUSSEX	International
UNIV SUSSEX	International
UNIV SYDNEY	International
UNIV SYDNEY FLORANCE	International
UNIV SZCZECIN	International
UNIV SZEGED	International
UNIV TALCA	International
UNIV TAMPERE	International
UNIV TARAPACA	International
UNIV TARTU	International
UNIV TASMANIA	International
UNIV TECH BRNO	International
UNIV TECH FEDERICO SANTA MARIA	International
UNIV TECH METROPOLITANA	International
UNIV TECHNOL	International
UNIV TECHNOL SYDNEY	International
UNIV TECN LISBON	International
UNIV TEESSIDE	International
UNIV TEHRAN	International
UNIV TEHRAN MED SCI	International
UNIV TEKNOL MALAYSIA	International
UNIV TEKNOL MARA	International
UNIV TEKNOL PETRONAS	International
UNIV TENAGA NASIONAL	International
UNIV TEXAS MD ANDERSON CANC CTR	International
UNIV THESSALY	International
UNIV TOKUSHIMA	International
UNIV TOKYO	International
UNIV TOLIMA	International
UNIV TOULOUSE	International
UNIV TOULOUSE 3	International
UNIV TOULOUSE LE MIRAIL	International
UNIV TRENTO	International
UNIV TRIESTE	International
UNIV TRNAVA	International
UNIV TROMSO	International
UNIV TSUKUBA	International
UNIV TUBINGEN	International
UNIV TUN HUSSEIN ONN MALAYSIA	International
UNIV TUNKU ABDUL RAHMAN	International
UNIV TURIN	International
UNIV TURKU	International
UNIV TWENTE	International
UNIV UDINE	International
UNIV ULM	International
UNIV ULSAN	International
UNIV ULSTER	International
UNIV UPPSALA	International
UNIV UTARA MALAYSIA	International
UNIV UTRECHT	International
UNIV VALENCIA	International
UNIV VALLADOLID	International
UNIV VALLADOLID IBGM UVA	International
UNIV VALPARAISO	International
UNIV VENDA	International
UNIV VERONA	International
UNIV VERSAILLES	International
UNIV VERSAILLES ST-QUENTIN-EN-YVELINES	International
UNIV VET & ANIM SCI	International
UNIV VET & PHARMACEUT SCI BRNO	International
UNIV VET MED VIENNA	International
UNIV VETERINARY MED KOSICE	International
UNIV VICTOR SEGALEN	International
UNIV VICTOR SEGALEN - BORDEAUX II	International
UNIV VIENNA	International
UNIV VIGO	International
UNIV VITA SALUTE SAN RAFFAELE	International
UNIV W BOHEMIA PILSEN	International
UNIV W ENGLAND	International
UNIV W HUNGARY	International
UNIV W INDIES	International
UNIV W LONDON	International
UNIV W SCOTLAND	International
UNIV WAIKATO	International
UNIV WALES NEWPORT	International
UNIV WALES TRINITY ST DAVID	International
UNIV WARMIA & MAZURY	International
UNIV WARSAW	International
UNIV WARWICK	International
UNIV WEST BRETAGNE	International
UNIV WEST CAPE	International
UNIV WEST INDIES	International
UNIV WESTERN AUSTRALIA	International
UNIV WESTERN MACEDONIA	International
UNIV WESTERN SYDNEY	International
UNIV WESTMINSTER	International
UNIV WINCHESTER	International
UNIV WITWATERSRAND	International
UNIV WOLLONGONG	International
UNIV WOLVERHAMPTON	International
UNIV WORCESTER	International
UNIV WROCLAW	International
UNIV WURZBURG	International
UNIV YAMANASHI	International
UNIV YAOUNDE I	International
UNIV YORK	International
UNIV YORK	International
UNIV ZADAR	International
UNIV ZAGREB	International
UNIV ZARAGOZA	International
UNIV ZIEKENHUIS BRUSSEL	International
UNIV ZIELONA GORA	International
UNIV ZILINA	International
UNIV ZULULAND	International
UNIV ZURICH	International
UNIVERS HOSP ERLANGEN	International
UNIVERSAL COLL LEARNING	International
UNIVERSAL HOSPITALS GROUP	International
UPMC CARDIOVASC INST	International
UPPSALA ACAD HOSP	International
UPPSALA UNIV	International
URAL STATE UNIV	International
USAK UNIV	International
UTSUNOMIYA UNIV	International
V.N. KARAZIN KHARKIV NATL UNIV	International
VA ANN ARBOR HEALTHCARE SYST	International
VA PALO ALTO HLTH CARE SYST	International
VAAL UNIV TECHNOL	International
VAASA CENT HOSP	International
VACCINE RES CTR	International
VADYM HETMAN KIEV NATL ECON UNIV	International
VAN EAH	International
VAN YUKSEK IHTISAS EAH	International
VARNA FREE UNIV	International
VAXJO UNIV	International
VEJLE HOSP	International
VELIKO TARNOVO UNIV	International
VENETAN INST MOL MED	International
VENTANA MED SYST	International
VERONA UNIV HOSP	International
VERTEX PHARMACEUT INC	International
VET ADM HEALTHCARE SYST	International
VET ADM MED CTR	International
VET AFFAIRS HEALTHCARE SYST	International
VET AFFAIRS PUGET SOUND HLTH CARE SYST	International
VET AFFAIRS SAN DIEGO HEALTHCARE SYST	International
VETERINARY RES INST	International
VIB	International
VIB & KULEUVEN	International
VIBORG HOSP	International
VICTORIA UNIV	International
VICTORIA UNIV WELLINGTON	International
VIENNA UNIV ECON & BUSINESS	International
VIENNA UNIV TECHNOL	International
VIETNAM NATL UNIV	International
VIETNAM NATL UNIV HANOI	International
VIETNAM NATL UNIV HOCHIMINH CITY	International
VILNIUS UNIV	International
VISAYAS STATE UNIV	International
VISTA UNIV	International
VORONEZH STATE UNIV	International
VRIJE UNIV AMSTERDAM	International
VRIJE UNIV BRUSSEL	International
VRIJE UNIV BRUSSELS	International
VU UNIV AMSTERDAM	International
W POMERANIAN UNIV TECHNOL	International
W UNIV TIMISOARA	International
WADIA INST HIMALAYAN GEOL	International
WAGENINGEN UNIV & RES CTR	International
WAIARIKI INST TECHNOL	International
WAIKATO INST TECHNOL	International
WAKAYAMA MED UNIV	International
WAKAYAMA UNIV	International
WALAILAK UNIV	International
WALTER & ELIZA HALL INST	International
WALTER & ELIZA HALL INST MED RES	International
WALTER SISULU UNIV TECHNOL & SCI	International
WALTON NEUROSCI CTR NHS FDN TRUST	International
WARSAW AGR UNIV	International
WARSAW SCH ECON	International
WARSAW UNIV LIFE SCI	International
WARSAW UNIV OBSERV	International
WARSAW UNIV TECHNOL	International
WARWICKSHIRE NATL HLTH SERV TRUST	International
WASEDA UNIV	International
WASHAGAMIS BAY FIRST NATION	International
WEINSTEIN IMAGING ASSOC	International
WEIS CTR RES	International
WEIZMANN INST SCI	International
WELCOME TRUST CTR CELL BIOL	International
WELLCOME RES LABS	International
WELLCOME TRUST CTR CELL BIOL	International
WELLCOME TRUST SANGER INST	International
WELLESLEY COLL	International
WELLINGTON INST TECHNOL	International
WENZHOU MED COLL	International
WENZHOU UNIV	International
WESTERN INST TECHNOL TARANAKI	International
WESTMEAD HOSP	International
WEXFORD GEN HOSP	International
WHITEHEAD INST BIOMED RES	International
WHITIREIA COMMUNITY POLYTECH	International
WHO	International
WHO WESTERN PACIFIC REG OFF	International
WICELL RES INST	International
WILLIAM BEAUMONT HOSP	International
WILLS EYE INST	International
WILSON CTR	International
WOMANS COLL	International
WOMEN & INFANTS RES FDN	International
WOMEN & INFANTS RES FDN WESTERN AUSTRALIA	International
WOMENS & CHILDRENS HOSP ADELAIDE	International
WOMENS COLL HLTH RES INST	International
WOMENS COLL HOSP CAMPUS	International
WOMENS COLL RES INST	International
WOMENS HOSP UNIV ULM	International
WONKWANG UNIV	International
WORKING ORDER	International
WORLD HLTH ORG	International
WORLDFISH CTR	International
WRIGHT STATE UNIV	International
WRITTLE COLL	International
WROCLAW UNIV ECON	International
WROCLAW UNIV ENVIRONM & LIFE SCI	International
WROCLAW UNIV TECHNOL	International
WUHAN INST TECHNOL	International
WUHAN UNIV	International
WUHAN UNIV SCI & TECHNOL	International
WUHAN UNIV TECHNOL	International
X PRIZE FDN	International
XIAMEN UNIV	International
XIAN JIAOTONG UNIV	International
XIAN MODERN CHEM RES INST	International
XIAN UNIV TECHNOL	International
XIANGTAN UNIV	International
XIDIAN UNIV	International
XINJIANG UNIV	International
XUZHOU MED COLL	International
XUZHOU NORMAL UNIV	International
YAKIN DOGU UNIV	International
YALOVA UNIV	International
YAMAGATA UNIV	International
YAMAGUCHI UNIV	International
YANBIAN UNIV	International
YANGZHOU UNIV	International
YANSHAN UNIV	International
YANTAI UNIV	International
YASAR UNIV	International
YEDITEPE UNIV	International
YEUNGNAM UNIV	International
YILDIZ TEKNIK UNIV	International
YOKOHAMA CITY UNIV	International
YOKOHAMA NATL UNIV	International
YONSEI UNIV	International
YORK ST JOHN UNIV	International
YORKSHIRE REG GENET SERV	International
YUAN ZE UNIV	International
YUNNAN NORMAL UNIV	International
YUNNAN UNIV	International
YUZUNCU YIL UNIV	International
ZHEJIANG ACAD AGR SCI	International
ZHEJIANG NORMAL UNIV	International
ZHEJIANG UNIV	International
ZHEJIANG UNIV TECHNOL	International
ZHENGZHOU UNIV	International
ZIAUDDIN UNIV	International
ZIRVE UNIV	International
ZNA MIDDELHEIM	International
ZONGULDAK KARAELMAS UNIV	International
ZURICH UNIV APPL SCI	International
514 DONNELLY CTR CELLULAR & BIOMOL RES	UNIV TORONTO
5289 UNIV OREGON	Other
5289 UNIV OREGON	Other
A CARDARELLI HOSP	Other
AA BOGOMOLETS PHYSIOL INST	Other
AALBORG & AARHUS UNIV	Other
ABBOTT LABS	Other
ABERDEEN ROYAL INFIRM	Other
ABO AKAD UNIV	Other
ACOUST MEDSYST INC	Other
ACT MOTIF INC	Other
ACTIVEO	Other
ADDENBROOKES HOSP	Other
ADV MEDICARE & RES INST	Other
AFFINIUM PHARMACEUT INC	Other
AFFYMETRIX INC	Other
AGENCE BIOMED	Other
AGENCE SANTE & SERV SOCIAUX MONTEREGIE	Other
AGILENT	Other
AGR & AGRI FOOD CANADA	Other
AIR FORCE OFF SCI RES	Other
AIR FORCE RES LAB	Other
AIX MARSEILLE UNIV	Other
ALBANOVA UNIV CTR	Other
ALDER HEY CHILDRENS HOSP	Other
ALFRED & MONASH UNIV	Other
ALFRED HOSP	Other
ALFRED I DUPONT HOSP CHILDREN	Other
ALGEMEINE ZIEKENHUIS GROENINGHE	Other
ALLERGAN PHARMACEUT INC	Other
ALMOND BOARD CALIF	Other
ALMOND BOARD CALIFORNIA	Other
ALPCO DIAGNOST	Other
ALPHARMA	Other
ALTONAER KINDERKRANKENHAUS	Other
AMGEN EUROPE GMBH	Other
AMICUS THERAPEUT	Other
AMK RES INC	Other
ANALGESIC RES	Other
ANDALUSIAN STEM CELL BANK	Other
AP HP	Other
APHASIA INST	Other
APO PHARMA INC	Other
APOPHARMA INC	Other
APPL BIOSYST INC	Other
APPL BIOSYST PART LIFE TECHNOL	Other
ARTHRIT COMMUNITY RES & EVALUAT UNIT	Other
ARTHRITIS CTR EXCELLENCE	Other
ASCO	Other
ASKLEPIOS KLIN ST GEORG	Other
ASSAF HAROFE MED CTR	Other
ASTELLAS PHARMA GLOBAL DEV	Other
ASTELLAS PHARMA INC	Other
ASTELLAS RES INST AMER LLC	Other
ASTRAZENECA	Other
ASTRAZENECA R&D	Other
ATLANTIC HLTH SCI CORP	Other
AUTISM RES PROGRAM	Other
AUTISM SPEAKS	Other
AXELA BIOSENSORS	Other
B RAPPAPORT FAC MED	Other
B RAPPAPORT FAC MED TECHN	Other
BC CTR DIS CONTROL	Other
BCCDC	Other
BEATSON INST CANC RES	Other
BEIKE BIOTECH CO LTD	Other
BGI SHENZHEN	Other
BICHAT CLAUDE BERNARD UNIV HOSP	Other
BIOBANK POPGEN	Other
BIOBASE CORP	Other
BIOCTR KUOPIO	Other
BIOFIG CTR BIODIVERS FUNCT & INTEGRAT GENOM	Other
BIOFORTIS	Other
BIOINFORMED CONSULTING SERV	Other
BIOL RES CTR	Other
BIOMED NETWORK RES CTR RARE DIS	Other
BIOMED RES CTR CIBERESP	Other
BIONEER CORP	Other
BIOPOLIS	Other
BIOPT LAB	Other
BIORESOURCE COLLECT & RES CTR	Other
BIOSCIENTIA INST MED DIAGNOST	Other
BOEHRINGER INGELHEIM PHARMA GMBH & CO KG	Other
BOEHRINGER INGELHEIM PHARMACEUT INC	Other
BONE & JOINT REHABIL R&D CTR	Other
BOOTH HALL CHILDRENS HOSP	Other
BOSTWICK LABS	Other
BRAIN BANK NAVARRA	Other
BRAIN INJURY SERV NO ONTARIO	Other
BRISTOL MYERS SQUIBB CO	Other
BROOKE ARMY MED CTR	Other
BUCKS INST AGE RES	Other
BWH ACAD HOSPITALIST SERV	Other
CABI EUROPE UK	Other
CADHAM PROV LAB	Other
CADHAM PROV LABS	Other
CANC EPIDEMIOL CTR	Other
CANC GENOM CTR	Other
CANC PREVENT INST CALIF	Other
CANC RES INST	Other
CANCOG TECHNOL	Other
CANGENETEST RES CONSORTIUM GENET LAB SERV	Other
CAPHRI RES INST	Other
CARDIAC REHABIL & SECONDARY PREVENT PROGRAM	Other
CARDIOVASC RES CTR	Other
CARESTREAM HLTH INC	Other
CARESTREARN HLTH INC	Other
CARGILL INC	Other
CARTAGENE	Other
CARVER COLL MED	Other
CATALAN INST ONCOL IDIBELL	Other
CATHARINA HOSP	Other
CBI HLTH	Other
CEA	Other
CEDERINDT	Other
CEGEP JONQUIERE	Other
CELGENE CORP	Other
CELL SIGNALING TECHNOL	Other
CELL SIGNALING TECHNOL INC	Other
CELLARTIS AB	Other
CENT ARKANSAS VET HEALTHCARE SYST	Other
CENTOCOR PHARMACEUT	Other
CEPHALON INC	Other
CEREXA	Other
CERIM	Other
CESP CTR RES EPIDEMIOL & POPULAT HLTH	Other
CHA HOSP	Other
CHAIM CHEBA MED CTR	Other
CHAIM SHEBA MED CTR	Other
CHEIL HOSP	Other
CHEIL HOSP & WOMENS HEALTHCARE CTR	Other
CHEJU NATL UNIV	Other
CHILD & FAMILY RES INST	Other
CHILD HLTH PROGRAM	Other
CHILDRENS HOSP	Other
CHR GRAND PORTAGE	Other
CHRIS HANI BARAGWANATH HOSP	Other
CHRISTIAN MED COLL & HOSP	Other
CHROMA TECHNOL CORP	Other
CHS NATL CANC CONTROL CTR	Other
CHSRF CIHR HLTH SERV	Other
CIRRIS	Other
CIRSE CENT OFF	Other
CLCC GEORGES FRANCOIS LECLERC	Other
CLCC PAUL STRAUSS	Other
CLEAR CANVAS	Other
CLERA INC	Other
CLIN GENOLIER	Other
CLIN JWG UNIV	Other
CLIN MEDELLIN	Other
CLIN NEUROPSYCHOL SERV	Other
CLIN SEMANT GRP	Other
CLIN TRIALS & SURVEYS CORP	Other
CLINCAL & FORENS TOXICOL	Other
CNRS	Other
COGENTECH	Other
COLL MT ST VINCENT	Other
COMBINATORX INC	Other
COMMISS EUROPEAN COMMUNITIES	Other
COMMUNITY HEAD INJURY RESOURCE SERV CHIRS	Other
COMPATH	Other
COMPETENCE CTR SYST PHYSIOL & METAB DIS	Other
COMPREHENS CANC CTR E	Other
COMPREHENS CANC CTR S	Other
CONSEJO SUPER INVEST CIENT	Other
CONSTANTINE PHILOSOPHER UNIV NITRA	Other
CONSTRUCT SAFETY ASSOC	Other
CONSULTANT HLTH RES ETH & POLICY	Other
COOPER UNION ADV SCI & ART	Other
CORBEIL ESSONNES HOSP	Other
COTA HLTH	Other
COURTYARD GRP	Other
CREANUTRITION AG	Other
CRLCC VAL AURELLE	Other
CRUCES HOSP BARAKALDO	Other
CTR ACT PREVENT & READAPTAT INCAPACITE TRAVAIL	Other
CTR ANTOINE LACASSAGNE	Other
CTR BIOL & PATHOL	Other
CTR CLIN	Other
CTR COMMUN CYTOMETRIE FLUX	Other
CTR DIS CONTROL & PREVENT	Other
CTR ESTUDIOS RADIOL INTEGRALES MAMA	Other
CTR ETUD POLYMORPHISME HUMAIN	Other
CTR FRANCOIS BACLESSE	Other
CTR GENET	Other
CTR GERIATR RES EDUC & CLIN	Other
CUNY	Other
DAFRA PHARMA INT	Other
DAIICHI SANKYO CO	Other
DAIICHI SANKYO CO LTD	Other
DEBBIE KATSARELIS	Other
DEBRECEN UNIV MED	Other
DECODE GENET	Other
DELTAQUEST FDN INC	Other
Dennis	Other
DEPT BIOCHEM	UNIV TORONTO
DEPT BIOINFORMAT	UNIV TORONTO
DEPT CELL & SYST BIOL	UNIV TORONTO
DEPT CELL BIOL & BIOPHYS	UNIV TORONTO
DEPT CHEM ENGN & APPL CHEM	UNIV TORONTO
DEPT CLIN GENET	UNIV TORONTO
DEPT DIAGNOST IMAGING	UNIV TORONTO
DEPT ECOL & EVOLUTIONARY BIOL	UNIV TORONTO
DEPT GENET EPIDEMIOL	UNIV TORONTO
DEPT HLTH SCI RES	UNIV TORONTO
DEPT HLTH STUDIES & GERONTOL	UNIV TORONTO
DEPT INTERNAL MED	UNIV TORONTO
DEPT LAB MED	UNIV TORONTO
DEPT LAB MED & PATHOBIOL	UNIV TORONTO
DEPT LAB MED & PATHOL	UNIV TORONTO
DEPT MED BIOPHYS	UNIV TORONTO
DEPT MED GENET	UNIV TORONTO
DEPT MOL & MED GENET	UNIV TORONTO
DEPT MOL GENET	UNIV TORONTO
DEPT NEUROIMAGING	UNIV TORONTO
DEPT NUTR SCI	UNIV TORONTO
DEPT ONCOL & SURG SCI	UNIV TORONTO
DEPT PATHOBIOL	UNIV TORONTO
DEPT PHYS THERAPY REHABIL SCI BLDG	UNIV TORONTO
DEPT PHYSIOL	UNIV TORONTO
DEPT PLAST SURG	UNIV TORONTO
DEPT SURG ONCOL	UNIV TORONTO
DEPT VET AFFAIRS	UNIV TORONTO
DIRECT REG SERV MED ASSURANCE MALAD	Other
DIRECT REGIONALE SERV MED ASSURANCE MALAD	Other
DIRECT SANTE PUBL MONTREAL	Other
DLR	Other
DOE JOINT GENOME INST	Other
DOWN SYNDROME RES FDN	Other
Drutz	Other
DVS SCI INC	Other
DYNACARE KASPER MED LABS	Other
ELAN PHARMACEUT INC	Other
ELLESMERE XRAY & ASSOCIATES	Other
ELLESMERE XRAY ASSOCIATES	Other
EMBL EUROPEAN BIOINFORMAT INST	Other
ENDO PHARMACEUT INC	Other
ENGN SERV INC	Other
EORTC DATA CTR	Other
EPITOMICS INC	Other
EQUIPE ACCUEIL SANTE INDIVIDU SOC	Other
ERASMUS MED CTR	Other
ESH SOFTWARE DESIGN & IMPLEMENTAT LTD	Other
ESTONIAN BIOCTR	Other
EUROPEAN ACAD BOZEN BOLZANO EURAC	Other
EUROPEAN BIOINFORMAT INST	Other
EUROPEAN COMMISS	Other
EUROPEAN HOSP	Other
EUROPEAN MOLEC BIOL LAB	Other
EUROPEAN ORG RES & TREATMENT CANC HEADQUARTERS	Other
EVANGEL KLINIKEN BONN GGMBH	Other
EVANSTON NW HEALTHCARE	Other
EVASC MED SYST	Other
EXPRESS PATHOL INC	Other
FAC MED	Other
FAC MED RTH LAENNEC	Other
FED CTR HLTHCARE KNOWLEDGE KCE	Other
FED MINIST EDUC & RES	Other
FETAL PHYSIOL FDN	Other
FIELD MUSEUM NAT HIST	Other
FINNISH CANC REGISTRY	Other
FIRC INST MOL ONCOL	Other
FLINDERS MED CTR	Other
FOLKHALSAN RES CTR	Other
FORENS EXAMINER TOXICOL	Other
FORSCHUNGSZENTRUM JULICH	Other
FORSYTH INST	Other
FRANKLIN W OLIN COLL ENGN	Other
FRASER HLTH AUTHOR	Other
FRED HUTCHINSON CANC RES CTR	Other
FREE UNIV BRUSSELS	Other
FREIE UNIVARTMENTERSITAT BERLIN	Other
FRIEDRICH MIESCHER INST	Other
FUNDENI CLIN INST	Other
FUTUREHEALTH INC	Other
G GASLINI INST CHILDREN	Other
GAMMA DYNACARE MED LABS	Other
GARTNAVEL ROYAL HOSP	Other
GATSBY COMPUTAT NEUROSCI UNIT	Other
GE HEALTHCARE	Other
GE HEALTHCARE CANADA	Other
GENE BRIDGES GMBH	Other
GENEDX	Other
GENELEX CORP	Other
GENENTECH INC	Other
GENET MED CENT CALIF UCSF	Other
GI FDN S AFRICA	Other
GLADSTONE INST CARDIOVASC DIS	Other
GLAN CLWYD GEN HOSP	Other
GLAXOSMITHKLINE INC	Other
GLENFIELD GEN HOSP	Other
GLOBALSTEM INC	Other
GLOSTRUP HOSP	Other
GLYCAEM INDEX TESTING INC	Other
GLYCEM INDEX LABS	Other
GLYCEM INDEX LABS INC	Other
GLYCEMIC INDEX LABS INC	Other
GOTHENBURG UNIV	Other
GOVT COLL	Other
GOVT INDIA	Other
GRAD DEPT REHABIL SCI	Other
GRAN VIA HOSP	Other
GRAZ TECH UNIV	Other
GREAT ORMOND ST HOSP CHILDREN	Other
GREATER BALTIMORE MED CTR	Other
GREENWOOD GENET CTR	Other
GREY NUNS HOSP	Other
H LEE MOFFITT CANC CTR & RES INST	Other
HAAGLANDEN MC	Other
HAGEDORN RES INST	Other
HAMLINE UNIV	Other
HAMMERSMITH HOSP	Other
HANNAM FERTIL CTR	Other
HARTFORD HOSP	Other
HASKINS LABS INC	Other
HAUKELAND UNIV HOSP	Other
HCSC	Other
HEBREW SENIOR LIFE	Other
HEBREW SENIORLIFE	Other
HEGAU KLINIKUM SINGEN	Other
HELICOS BIOSCI CORP	Other
HELIOS HOSP	Other
HELLEN CTR DIS CONTROL & PREVENT	Other
HELMHOLTZ ZENTRUM MUNCHEN	Other
HENDERSON HOSP	Other
HENNEPIN CTY MED CTR	Other
HENRY FORD HOSP	Other
HINXTON	Other
HIROSAKI UNIV	Other
HOLY NAME HOSP	Other
HOMEWOOD RES INST	Other
HSC PEDIAT CTR	Other
HUDSONALPHA INST BIOTECHNOL	Other
HULL ROYAL INFIRM	Other
HUMAN MATRIX SCI LLC	Other
HUMBER RIVER REG HOSP	Other
HUNTSMAN CANC INST	Other
IATSL	Other
IBARAKI PREFECTURAL HANDICAPPED CHILDRENS CTR	Other
IDIBELL CATALAN INST ONCOL	Other
IEO	Other
IFR	Other
IFR 128	Other
IFR 143	Other
IFR 50	Other
ILLUMINA INC	Other
ILSAN JEIL WOMENS HOSP	Other
IMAGING RES	Other
IMAGING RES CTR	Other
IMAM HOSP	Other
IMGENEX INDIA PVT LTD	Other
IMMUNOPRECISE ANTIBODIES LTD	Other
IMMUNOTEC RES LTD	Other
IN VITRO DRUG SAFETY & BIOTECHNOL	Other
INCOR	Other
IND RES LTD	Other
INOVOBIOL INC	Other
INRA	Other
INSA	Other
INSCEPT BIOSCI	Other
INSERM	Other
INST ADV STUDY	Other
INST AGING RES	Other
INST ANDRE LWOFF	Other
INST BIOCHEM & BIOPHYS	Other
INST BIOCHIM & BIOPHYS MOL & CELLULAIRE	Other
INST BIOINFORMAT	Other
INST BIOMAT & BIOMED ENGN	Other
INST BIOORGAN CHEM NASB	Other
INST CURIE	Other
INST ENTOMOL	Other
INST SPORTS MED	Other
INST SURG RES	Other
INST SYST BIOL	Other
INST UNIV CARDIOL & PNEUMOL QUEBEC	Other
INST VALENCIANO ONCOL	Other
INST WORK & HLTH	Other
INT AGCY RES CANC	Other
INT DIABET INST	Other
INT GENOM CONSORTIUM	Other
INT INST NEUROSCI NATAL EDMOND & LILY SAFRA	Other
INT SOC STEM CELL RES	Other
IRCC	Other
IRCCS	Other
IRCCS FDN	Other
IUF	Other
KRAFT FOODS GLOBAL LLC	Other
LIFE TECHNOL	Other
LIFE TECHNOL CORP	Other
LIFELABS MED LAB SERV	Other
LIFEMARK HLTH MANAGEMENT INC	Other
LIFEQUEST CTR REPROD MED	Other
LILLE UNIV HOSP	Other
Liz	Other
LONDON HLTH SCI CTR	Other
LONDON INDEPENDENT HOSP	Other
LONDON INST	Other
MAKERERE UNIV	Other
MALAGHAN INST MED RES	Other
MALIN SPACE SCI SYST INC	Other
MALLINCKRODT INST RADIOL	Other
MALMSKA MUNICIPAL HLTH CTR & HOSP	Other
MARQUETTE LAW SCH	Other
MARSHFIELD CLIN FDN MED RES & EDUC	Other
MARYLAND PSYCHIAT RES CTR	Other
MARYLAND ZOO	Other
MASARYK MEM CANC INST	Other
MASARYK UNIV	Other
MCTT INC	Other
MDS SCIEX	Other
MED EXAMINER MILWAUKEE CTY	Other
MED FAC ASSOCIATES	Other
MED FAC HOSP	Other
MED NEUROGENET	Other
MED RES INST	Other
MED UNIV	Other
MELLITECH	Other
MENOUFIA UNIV	Other
MENTAL HLTH RES INST VICTORIA	Other
MERCK & CO INC	Other
MICROARRAY CTR	Other
MICROSOFT CORP	Other
MILLIPORE CORP	Other
MILTENYI BIOTEC	Other
MILTENYI BIOTEC GMBH	Other
MIND RES NETWORK	Other
MIND RES NETWORK MRN	Other
MINIST SANTE & SERV SOCIAUX	Other
MINIST SCI & INNOVAT	Other
MISSISSAUGA & GREATER TORONTO AREA	Other
MLF CONSULTING	Other
MOLECULARMD	Other
MRC	Other
NAT & NAT RES JOURNALS	Other
NAT RESOURCES CANADA	Other
NATHAN KLINE INST PSYCHIAT RES NKI	Other
NATHAN S KLINE INST PSYCHIAT RES NKI	Other
NATIONWIDE CHILDRENS HOSP	Other
NATL ACAD SCI	Other
NATL CTR CELL SCI	Other
NATL CTR COMPETENCE RES FRONTIERS GENET	Other
NATL CTR STREPTOCOCCUS	Other
NATL CTR TUMOR DIS	Other
NATL INST BIOL STAND & CONTROL HLTH PROTECT AGCY	Other
NATL INST BIOL STAND & CONTROLS	Other
NATL INST BIOMED GENOM	Other
NATL INST INFECT DIS	Other
NATL INST MED RES	Other
NATL INST NEUROL DISORDERS	Other
NATL INST NEUROSCI	Other
NATL INST NEUROSURG	Other
NATL INST STAND & TECHNOL	Other
NATL INST WELF & HLTH	Other
NATL JEWISH CTR IMMUNOL & RESP MED	Other
NATL LIB MED	Other
NATL MICROBIOL LAB	Other
NATL NAVAL MED CTR	Other
NATL PUBL HLTH INST	Other
NATL PUBL HLTH INST KTL	Other
NATL REHABIL CTR PERSONS DISABIL	Other
NATL RES & DEV CTR WELFARE & HLTH	Other
NATL STARCH LLC	Other
NCI	Other
NCIC CLIN TRIALS GRP	Other
NEI	Other
NHGRI	Other
NHLBI	Other
NHS GRAMPIAN	Other
NIA	Other
NIAAA	Other
NIAID	Other
NIAMS	Other
NICHD	Other
NICOTINE DEPENDENCE CLIN	Other
NIDDK	Other
NIEHS	Other
NIH	Other
NIMH	Other
NINDS	Other
NINR	Other
NIPIGON DIST MEM HOSP	Other
NMVAHCS	Other
NN ALEXANDROV RES INST ONCOL & MED RADIOL	Other
NN BLOKHIN RUSSIAN CANC RES CTR	Other
NN PETROV INST ONCOL	Other
NN PETROV INST RES INST	Other
NN PETROV ONCOL RES INST	Other
NO CALIF CANC CTR	Other
NO ONTARIO SCH MED	Other
NOFER INST OCCUPAT MED	Other
NOVA BIOMED	Other
NOVARTIS INST BIOMED RES	Other
NOVARTIS KNOWLEDGE CTR	Other
NOVARTIS PHARMA AG	Other
NOVARTIS RES FDN	Other
NPS PHARMACEUT INC	Other
NUTR COACHING LLC	Other
NUTRISCI BV	Other
OAS	Other
OBJECT PATHOL SERV	Other
OBRIEN INST	Other
OCCUPAT HLTH CLIN ONTARIO WORKERS INC	Other
OCGN	Other
OICR	Other
OMICIA	Other
OOTA MEM HOSP	Other
OPEN BIOSYST	Other
ORIGENE TECHNOL	Other
ORLA PROT TECHNOL LTD	Other
ORTHOPED UNIV HOSP BALGRIST	Other
OSPED BELCOLLE	Other
OSPED CASA SOLLIEVO SOFFERENZA	Other
OSPED NIGUARDA CA GRANDA	Other
OSPED SAN GIOVANNI BELLINZONA	Other
OSPED SANTA CROCE	Other
OUR LADY LOURDES HOSP	Other
OUR LADY LOURDES MED CTR	Other
OUR LADY LOURDES REG MED CTR	Other
OY FOODFILES LTD	Other
PACIFIC NEPHROL ASSOC	Other
PALACKY UNIV	Other
PALO ALTO HLTH CARE SYST	Other
PARACELSUS MED UNIV	Other
PARI PHARMA GMBH	Other
PARKWOOD HOSP	Other
PCSIR LAB COMPLEX	Other
PENINSULA COLL MED & DENT	Other
PENINSULA MED SCH	Other
PERLEGEN SCI	Other
PETER A SILVERMAN CTR INT HLTH	Other
PFIZER GLOBAL RES & DEV	Other
PFIZER INC	Other
PFIZER PHARMACEUT INC	Other
PHARMA CLIN AG	Other
PHARMAREASONS	Other
PHARMAREASONS PHARMACOL RES & APPL SOLUT	Other
PHARMREASONS	Other
PHSA LABS	Other
PHYS COMM RESPONSIBLE MED	Other
PHYS TECH GESELL RADIOL MBH	Other
PHYSIOMICS PLC	Other
PHYSIOTHERAPY CTR	Other
PISA UNIV HOSP	Other
PIXONIMAGING LLC	Other
PLACENTARY HISTOTHERAPY CTR CHP	Other
PLYMOUTH HOSP NATL HLTH SERV TRUST	Other
PLYMOUTH HOSP NHS TRUST	Other
PLYMOUTH MARINE LAB	Other
POHANG ST MARYS HOSP	Other
POLICLIN A GEMELLI	Other
PONTIFICIA UNIV CATOLICA CHILE	Other
PONTIFICIA UNIV CATOLICA RIO GRANDE DO SUL	Other
PONTIFICIA UNIV JAVERIANA	Other
POTENTIAL GRP	Other
PREDICT MED	Other
PREMUP	Other
PRENATAL DIAG & MED GENET PROGRAM	Other
PRESIDENCY COLL	Other
PRIMARY CHILDRENS MED CTR	Other
PROVLAB	Other
PSC	Other
PSOMA THERAPEUT INC	Other
PUBL HLTH LAB	Other
PUBL POPULAT PROJECT GENOM P3G	Other
PUGET SOUND BLOOD CTR	Other
PURDUE PHARMA	Other
QUINTILES BIOSTAT	Other
RADIA	Other
TALBOT ADVISORS	Other
TERCICA	Other
THERMO FISHER SCI	Other
TMDT	Other
TMDT MARS CTR	UNIV TORONTO
TNO QUAL LIFE	Other
TOSHIBA MED SYST	Other
TOSHIBA MED SYST EUROPE BV	Other
TOSHIBA MED SYST GERMANY	Other
TOTAL GAS & POWER	Other
TRANSGEN CORE	Other
TRI SERV GEN HOSP	Other
UFR LEONARD DE VINCI	Other
UJF	Other
UK BIOBANK	Other
ULB	Other
UM2	Other
UPF	Other
USAF	Other
USDA	Other
VAST SCI	Other
VCU HLTH SYST	Other
VM INST RES	Other
VRC	Other
W PK HEALTHCARE CTR	Other
X PRIZE FDN	Other